elektronische-communicatienetwerken	elektronische-communicatienetwerken
intellectuele-eigendomsrechten	intellectuele-eigendomsrechten
spierweefselvermenigvuldigen	spierweefselvermenigvuldigen
zoekmachineoptimalisatie	zoekmachineoptimalisatie
crediteurenadministratie	crediteurenadministratie
onroerende-zaakbelastingen	onroerende-zaakbelastingen
Wikiwijsleermiddelenplein	Wikiwijsleermiddelenplein
openbaredienstverplichtingen	openbaredienstverplichtingen
nationaal-socialistische	nationaal-socialistische
autismespectrumstoornissen	autismespectrumstoornissen
Nationaal-Socialistische	Nationaal-Socialistische
groenestroomcertificaten	groenestroomcertificaten
Tweede-Kamerverkiezingen	Tweede-Kamerverkiezingen
informatieuitwisseling	informatieuitwisseling
uitgebreide-duurzame	uitgebreide-duurzame
populair-wetenschappelijke	populair-wetenschappelijke
neurodegeneratieve	neurodegeneratieve
anti-revolutionaire	anti-revolutionaire
gedematerialiseerde	gedematerialiseerde
sociaal-wetenschappelijke	sociaal-wetenschappelijke
Vreemdelingenbetwistingen	Vreemdelingenbetwistingen
Excellentiemogelijkheden	Excellentiemogelijkheden
Weefselvermenigvuldigen	Weefselvermenigvuldigen
Joegoslavië-tribunaal	Joegoslavië-tribunaal
corrosiebestendigheid	corrosiebestendigheid
uitgebreide-entrepot	uitgebreide-entrepot
effectief-gedoteerde	effectief-gedoteerde
vooropleidingseisen	vooropleidingseisen
nationaal-socialisten	nationaal-socialisten
beroepsbegeleidende	beroepsbegeleidende
geesteswetenschappelijke	geesteswetenschappelijke
pseudo-wetenschappelijke	pseudo-wetenschappelijke
autismespectrumstoornis	autismespectrumstoornis
nationaal-socialisme	nationaal-socialisme
veterinairrechtelijke	veterinairrechtelijke
Middellandse-Zeegebied	Middellandse-Zeegebied
reïntegratiebedrijven	reïntegratiebedrijven
powerpointpresentatie	powerpointpresentatie
agentuurovereenkomst	agentuurovereenkomst
vervoersmodaliteiten	vervoersmodaliteiten
placebogecontroleerde	placebogecontroleerde
niet-ontvankelijkverklaring	niet-ontvankelijkverklaring
voedselintolerantie	voedselintolerantie
uitgebreid-duurzame	uitgebreid-duurzame
mountainbikeroutes	mountainbikeroutes
Anti-Revolutionaire	Anti-Revolutionaire
allerindividueelste	allerindividueelste
locatiespecifieke	locatiespecifieke
middenveldorganisaties	middenveldorganisaties
Genealogiedomein	Genealogiedomein
eigenrisicodragerschap	eigenrisicodragerschap
Slotervaartziekenhuis	Slotervaartziekenhuis
reïntegratietrajecten	reïntegratietrajecten
heeeeeeeeel	heeeeeeeeel
plaveiselcelcarcinoom	plaveiselcelcarcinoom
lactose-intolerantie	lactose-intolerantie
Sociaal-economische	Sociaal-economische
sociaal-economische	sociaal-economische
procesoptimalisatie	procesoptimalisatie
Gouverneur-Generaal	Gouverneur-Generaal
explosiegevaarlijke	explosiegevaarlijke
sociaal-wetenschappelijk	sociaal-wetenschappelijk
europarlementariër	europarlementariër
sociaal-politieke	sociaal-politieke
klokkenluidersregeling	klokkenluidersregeling
Nationale-Nederlanden	Nationale-Nederlanden
cellenvermenigvuldigen	cellenvermenigvuldigen
sociaal-democratische	sociaal-democratische
luchtverontreinigende	luchtverontreinigende
gebiedsontsluitingsweg	gebiedsontsluitingsweg
bewerkersovereenkomst	bewerkersovereenkomst
spierweefselvergroten	spierweefselvergroten
Sociaal-Democratische	Sociaal-Democratische
huis-tuin-en-keuken	huis-tuin-en-keuken
terugleververgoeding	terugleververgoeding
levensloopbestendige	levensloopbestendige
leerwegondersteunend	leerwegondersteunend
Jurisprudentienummer	Jurisprudentienummer
directeur-bestuurder	directeur-bestuurder
cookie-instellingen	cookie-instellingen
vice-eersteminister	vice-eersteminister
uitgebreid-entrepot	uitgebreid-entrepot
teeltondersteunende	teeltondersteunende
sociaal-artistieke	sociaal-artistieke
semi-professionele	semi-professionele
semi-professioneel	semi-professioneel
retributiereglement	retributiereglement
Ziektewet-uitkering	Ziektewet-uitkering
vaatwasmachinebestendig	vaatwasmachinebestendig
sociaal-democratie	sociaal-democratie
leiderschapsontwikkeling	leiderschapsontwikkeling
Europeesrechtelijke	Europeesrechtelijke
defensieonderdelen	defensieonderdelen
corrosiebestendige	corrosiebestendige
bloedglucosespiegel	bloedglucosespiegel
anti-autoritaire	anti-autoritaire
voorgevelrooilijn	voorgevelrooilijn
hoogsensitiviteit	hoogsensitiviteit
gemeentebegrooting	gemeentebegrooting
Zevenheuvelenloop	Zevenheuvelenloop
Brussel-Halle-Vilvoorde	Brussel-Halle-Vilvoorde
Bezuidenhoutseweg	Bezuidenhoutseweg
voetreflexologie	voetreflexologie
neonicotinoïden	neonicotinoïden
mede-verantwoordelijk	mede-verantwoordelijk
gesecuritiseerde	gesecuritiseerde
driedimensionele	driedimensionele
domeinspecifieke	domeinspecifieke
Directoraat-Generaal	Directoraat-Generaal
com-gastenbeoordeling	com-gastenbeoordeling
wellnessfaciliteiten	wellnessfaciliteiten
verantwoordelijkheid’	verantwoordelijkheid’
teunisbloemolie	teunisbloemolie
Sint-Pietersbasiliek	Sint-Pietersbasiliek
siliciumdioxide	siliciumdioxide
rolstoeltoegankelijk	rolstoeltoegankelijk
Languedoc-Roussillon	Languedoc-Roussillon
kwaliteitverhouding	kwaliteitverhouding
kinderfysiotherapie	kinderfysiotherapie
boomkwekerijgewassen	boomkwekerijgewassen
Zuidoost-Aziatische	Zuidoost-Aziatische
uiteenloopende	uiteenloopende
souvereiniteit	souvereiniteit
Rolstoeltoegankelijk	Rolstoeltoegankelijk
rekenkamercommissie	rekenkamercommissie
reïntegratiebedrijf	reïntegratiebedrijf
niet-gecontracteerde	niet-gecontracteerde
natuurgeneeskundig	natuurgeneeskundig
Bodegraven-Reeuwijk	Bodegraven-Reeuwijk
assistentiewoningen	assistentiewoningen
achtergevelrooilijn	achtergevelrooilijn
vice-wereldkampioen	vice-wereldkampioen
podotherapeutische	podotherapeutische
Kinderfysiotherapie	Kinderfysiotherapie
interculturaliteit	interculturaliteit
Goeree-Overflakkee	Goeree-Overflakkee
glutenintolerantie	glutenintolerantie
Wii-afstandsbediening	Wii-afstandsbediening
voedselallergieën	voedselallergieën
Toulouse-Lautrec	Toulouse-Lautrec
sociaal-psychologische	sociaal-psychologische
Onafhankelijkheidsplein	Onafhankelijkheidsplein
homosexualiteit	homosexualiteit
continue-duurzame	continue-duurzame
verkeersaantrekkende	verkeersaantrekkende
televisieprogrammas	televisieprogrammas
Sociaal-Economische	Sociaal-Economische
revolutionnaire	revolutionnaire
neuromusculaire	neuromusculaire
Luik-Bastenaken-Luik	Luik-Bastenaken-Luik
ieniemienie	ieniemienie
heeeeeeeel	heeeeeeeel
Harvard-universiteit	Harvard-universiteit
Haarlemmermeerpolder	Haarlemmermeerpolder
gevirtualiseerde	gevirtualiseerde
fysiotherapiepraktijk	fysiotherapiepraktijk
civiel-militaire	civiel-militaire
bloedglucosewaarden	bloedglucosewaarden
audiodescriptie	audiodescriptie
warmterecuperatie	warmterecuperatie
sociaal-economisch	sociaal-economisch
semi-automatische	semi-automatische
reïntegratietraject	reïntegratietraject
rechtsplegingsvergoeding	rechtsplegingsvergoeding
Procureur-Generaal	Procureur-Generaal
onverenigbaarheden	onverenigbaarheden
nooit-omkeerbaar	nooit-omkeerbaar
laat-middeleeuwse	laat-middeleeuwse
doctoraatsonderzoek	doctoraatsonderzoek
Directeur-Generaal	Directeur-Generaal
audio-visuele	audio-visuele
Zuiderzeestraatweg	Zuiderzeestraatweg
volkshuisvestelijke	volkshuisvestelijke
stofvermenigvuldigen	stofvermenigvuldigen
sociaal-democraten	sociaal-democraten
paradigmaverschuiving	paradigmaverschuiving
organisatiebreed	organisatiebreed
organisatiebrede	organisatiebrede
Louvain-la-Neuve	Louvain-la-Neuve
Johannesevangelie	Johannesevangelie
hoogkwalitatieve	hoogkwalitatieve
gekarameliseerde	gekarameliseerde
geitenwollensokken	geitenwollensokken
echocardiografie	echocardiografie
Diapheromeridae	Diapheromeridae
anti-inflammatoire	anti-inflammatoire
alfa-linoleenzuur	alfa-linoleenzuur
Weerribben-Wieden	Weerribben-Wieden
vrijheidsbenemende	vrijheidsbenemende
voorvleugellengte	voorvleugellengte
voorgemonteerde	voorgemonteerde
uitvalsverschijnselen	uitvalsverschijnselen
topsectorenbeleid	topsectorenbeleid
terreinbeherende	terreinbeherende
temperatuursverschil	temperatuursverschil
telersverenigingen	telersverenigingen
spiegelneuronen	spiegelneuronen
sociaal-democratisch	sociaal-democratisch
sensortechnologie	sensortechnologie
Secretaris-Generaal	Secretaris-Generaal
restitutiepolis	restitutiepolis
praktijkondersteuners	praktijkondersteuners
praktijkondersteuner	praktijkondersteuner
Oosterweelverbinding	Oosterweelverbinding
onderbegroeiing	onderbegroeiing
oldtimerverzekering	oldtimerverzekering
Noordwest-Europese	Noordwest-Europese
Noordamerikaanse	Noordamerikaanse
Marokkaans-Nederlandse	Marokkaans-Nederlandse
losloopgebieden	losloopgebieden
loco-burgemeester	loco-burgemeester
Liefkenshoektunnel	Liefkenshoektunnel
levensloopbestendig	levensloopbestendig
kostenveroordeling	kostenveroordeling
kinderboekenweek	kinderboekenweek
kilometerbeprijzing	kilometerbeprijzing
Internet-encyclopedie	Internet-encyclopedie
inbreukprocedures	inbreukprocedures
immunoglobulinen	immunoglobulinen
herverdeeleffecten	herverdeeleffecten
Flevoziekenhuis	Flevoziekenhuis
energieneutraal	energieneutraal
ecosysteemdiensten	ecosysteemdiensten
doorschuifregeling	doorschuifregeling
doornuitsteeksels	doornuitsteeksels
corrosiebescherming	corrosiebescherming
continue-entrepot	continue-entrepot
bodembedreigende	bodembedreigende
biogasinstallaties	biogasinstallaties
belijdenisgeschriften	belijdenisgeschriften
Arteveldehogeschool	Arteveldehogeschool
andtemporaryincrease	andtemporaryincrease
Zuidamerikaanse	Zuidamerikaanse
zieleroerselen	zieleroerselen
zelforganiserende	zelforganiserende
Zeeuws-Vlaanderen	Zeeuws-Vlaanderen
win-win-situatie	win-win-situatie
weersafhankelijke	weersafhankelijke
weeromstandigheden	weeromstandigheden
weergegevenniet	weergegevenniet
vorenoverwogene	vorenoverwogene
voorovereenkomst	voorovereenkomst
vooroordeelen	vooroordeelen
voetbalhooligans	voetbalhooligans
Vlaams-nationalisme	Vlaams-nationalisme
vakvereenigingen	vakvereenigingen
twee-onder-een-kap	twee-onder-een-kap
traditioneele	traditioneele
Tirreno-Adriatico	Tirreno-Adriatico
stedebouwkundige	stedebouwkundige
sperdifferentieel	sperdifferentieel
socio-culturele	socio-culturele
sociaal-liberale	sociaal-liberale
sociaal-democraat	sociaal-democraat
securitisaties	securitisaties
securitisatie	securitisatie
sectorspecifieke	sectorspecifieke
Scrabblewoordenboek	Scrabblewoordenboek
schilderwerkzaamheden	schilderwerkzaamheden
Schelde-estuarium	Schelde-estuarium
ruimtelijkeplannen	ruimtelijkeplannen
Rooms-Katholieke	Rooms-Katholieke
Roomsch-Katholieke	Roomsch-Katholieke
retourformulier	retourformulier
reconventionele	reconventionele
raadsonderzoeker	raadsonderzoeker
prosumententarief	prosumententarief
precisielandbouw	precisielandbouw
polyneuropathie	polyneuropathie
Oostenrijk-Hongarije	Oostenrijk-Hongarije
ongeraffineerde	ongeraffineerde
ongeloofelijke	ongeloofelijke
ondergeteekenden	ondergeteekenden
ondergeteekende	ondergeteekende
niet-katholieken	niet-katholieken
neurowetenschappers	neurowetenschappers
neurowetenschapper	neurowetenschapper
neurowetenschappen	neurowetenschappen
Naamsvermelding-Gelijk	Naamsvermelding-Gelijk
muziekpedagoog	muziekpedagoog
municipaliteit	municipaliteit
moestuinieren	moestuinieren
moeielijkheden	moeielijkheden
metropoolregio	metropoolregio
menstruatieklachten	menstruatieklachten
meicirculaire	meicirculaire
mageremelkpoeder	mageremelkpoeder
loondispensatie	loondispensatie
langstudeerboete	langstudeerboete
kmo-portefeuille	kmo-portefeuille
Kinesiologie	Kinesiologie
kinesiologie	kinesiologie
Kiesvereeniging	Kiesvereeniging
kiesvereeniging	kiesvereeniging
kampioenskandidaat	kampioenskandidaat
kamerverkiezingen	kamerverkiezingen
kaderwetgebieden	kaderwetgebieden
intellectueelen	intellectueelen
intellectueele	intellectueele
insolventienummer	insolventienummer
individueele	individueele
inbreukprocedure	inbreukprocedure
immunoglobuline	immunoglobuline
hoogsensitieve	hoogsensitieve
hogedrukreinigers	hogedrukreinigers
Heuvelrugnieuws	Heuvelrugnieuws
Haringvlietsluizen	Haringvlietsluizen
gramofoonmuziek	gramofoonmuziek
goed-gedoteerde	goed-gedoteerde
goedbedoelende	goedbedoelende
gloeibougies	gloeibougies
georienteerde	georienteerde
geomorfologische	geomorfologische
Geneesmiddelenwet	Geneesmiddelenwet
genderidentiteit	genderidentiteit
gemetaboliseerd	gemetaboliseerd
gemeenschappelijkste	gemeenschappelijkste
gemeenschappelijken	gemeenschappelijken
geinteresseerden	geinteresseerden
geinteresseerde	geinteresseerde
geidentificeerd	geidentificeerd
geexperimenteerd	geexperimenteerd
gediagnostiseerd	gediagnostiseerd
gedachtenexperiment	gedachtenexperiment
gecontra-indiceerd	gecontra-indiceerd
extended-duurzame	extended-duurzame
exposeerdeniet	exposeerdeniet
engagementsverklaring	engagementsverklaring
doorsneepremie	doorsneepremie
Diakonessenhuis	Diakonessenhuis
Demeulemeester	Demeulemeester
corrosiebestendig	corrosiebestendig
Coördinatiewet	Coördinatiewet
cookieverklaring	cookieverklaring
cookiebeleid	cookiebeleid
configureerbare	configureerbare
condensatieketel	condensatieketel
christen-democratische	christen-democratische
Boudewijnstadion	Boudewijnstadion
Bonnefantenmuseum	Bonnefantenmuseum
Bloemendalerpolder	Bloemendalerpolder
bijnieruitputting	bijnieruitputting
bidirectionele	bidirectionele
basaalcelcarcinoom	basaalcelcarcinoom
bacteriedodende	bacteriedodende
atriumfibrilleren	atriumfibrilleren
asurprisingamount	asurprisingamount
antwoordelijkheid	antwoordelijkheid
airconditioners	airconditioners
afgescheidenheid	afgescheidenheid
aardbevingsbestendig	aardbevingsbestendig
