jaaaaaaaren	járen
veeeeeeel	véél
laissez	laissez-passer
zooooooo	zó
AZERTY-klavier	azertyklavier
heeeeeeele	héle
heeeeeeerlijk	héérlijk
Sint-	Sint-Maarten
Neeeeeee	Néé
Zooooooo	Zó
earning	inkomen
flexiewoorden	flexies
AZERTY-toetsenbord	azertytoetsenbord
maaaaaaar	máár
pdf-file	pdf-bestand
QWERTZ-toetsenbordje	qwertztoetsenbordje
QWERTZ-toetsenborden	qwertztoetsenborden
happie	gelukkig
oooooooh	óh
Koror	Melekeok
QWERTY-toetsenbordje	qwertytoetsenbordje
noooooooit	nóóit
QWERTY-klavieren	qwertyklavieren
ISB-nummer	ISBN
AZERTY-toetsenborden	azertytoetsenborden
QWERTY-toetsenbordjes	qwertytoetsenbordjes
AZERTY-klaviertjes	azertyklaviertjes
QWERTZ-klaviertjes	qwertzklaviertjes
QWERTY-klavier	qwertyklavier
AZERTY-klavieren	azertyklavieren
QWERTZ-toetsenbord	qwertztoetsenbord
seaports	zeehavens
QWERTY-toetsenborden	qwertytoetsenborden
procesverbalen	processen-verbaal
heeeeeeel	héél
BSN-nummer	BSN
QWERTZ-klaviertje	qwertzklaviertje
readership	relatie
QWERTY-klaviertje	qwertyklaviertje
CMS-systemen	CMS'en
seaport	zeehaven
belanghouders	belanghebbenden
Jaaaaaaa	Já
AZERTY-toetsenbordje	azertytoetsenbordje
QWERTZ-klavieren	qwertzklavieren
Heeeeeeel	Héél
driesterren-	drie-
AZERTY-klaviertje	azertyklaviertje
jeu-de-boulert	jeu-de-boulesspeler
neeeeeee	néé
QWERTY-toetsenbord	qwertytoetsenbord
AZERTY-toetsenbordjes	azertytoetsenbordjes
QWERTY-klaviertjes	qwertyklaviertjes
QWERTZ-toetsenbordjes	qwertztoetsenbordjes
zeeeeeeer	zéér
happier	gelukkiger
QWERTZ-klavier	qwertzklavier
aves	's avonds
Maaaaaar	Máár
Zoooooo	Zó
zaaaaaalig	zálig
weaknesses	zwakheden
synth	synthesizer
uuuuuuren	úren
URL-adres	URL
petanquert	petanquespeler
kansonderwijs	tweedekansonderwijs
kostenverslindende	geldverslindende
talkies	walkietalkies
jaaaaaaren	járen
maaaaaanden	máánden
fosdem	FOSDEM
fotografies	foto's
neeeeee	néé
helemaaaaaal	helemáál
laisser	laisser-faire
jaaaaaa	já
Airship	Luchtschip
Jaaaaaa	Já
votes	stemmen
threesome	trio
kansbeleid	tweedekansbeleid
relationships	relaties
heen-en-weer	heen-en-weergedouw
wallonnes	Waals
zeeeeeer	zéér
Kòrsou	Curaçao
kommies	commissaris
nvidia	NVIDIA
Neeeeee	Néé
heeeeeel	héél
Heeeeeel	Héél
veeeeeel	véél
maaaaaar	máár
laissez-	laissez-passer
voices	stemmen
monumentendag	Open Monumentendag
zoooooo	zó
kostenverslindend	geldverslindend
THT-datum	t.h.t.-datum
poene	straffe
German	Duits
synths	synthesizers
heeeeeerlijk	héérlijk
heeeeeele	héle
nooooooit	nóóit
Matlab	MATLAB
abusievelijke	abusieve
Vinex-nota	Vinex
ster-reclame's	STER-reclames
flexiewoordjes	flexietjes
ambt.	ambtelijk
excuser	verexcuseren
zooooo	zó
flexiewoordje	flexietje
disseminated	gedissemineerd
moooooi	móói
Gelukkiglijk	gelukkig
phoenix	feniks
flagship	vlaggenschip
houdswerkzaamheden	onderhoudswerkzaamheden
Bruxelles	Brussel
nVidia	NVIDIA
UNESCO	Unesco
Hallooooo	Halló
VINEX-lokatie	Vinex-locatie
VINEX-lokaties	Vinex-locaties
flexiewoord	flexie
dag-nacht	dag-nachtritme
BTW-verhogingen	btw-verhoging
verantwoordbaar	verantwoordelijk
NoordKorea	Zuid-Korea
Gooooooogle	Google
assenpoes	Assepoester
verantwoordbare	verantwoordelijke
ulcussen	ulcera
attacker	aanvaller
uppie	eentje
scheepslieden	scheepslui
commenters	commentatoren
Nvidia	NVIDIA
fants	fantasieën
vierliter	vierlitermotor
monopolyert	monopolyspeler
koeltoer	cultuur
zaaaaalig	zálig
Palauaans	Paulus
brinnummer	BRIN-nummer
UNICEF	Unicef
zoooooveel	zóveel
noooooit	nóóit
logeerdert	logee
attackers	aanvallers
brinnummers	BRIN-nummers
zeeeeer	zéér
trollende	pestende
mil	miljoen
burokratie	bureaucratie
servieswerk	serviesgoed
pvv-er	PVV'er
ship	tallship
urls	URL's
LGBT-gemeenschap	lgbt-gemeenschap
BTW-Richtlijn	btw-richtlijn
ict_integratie	ICT-integratie
véééééél	véél
Ster-reclame's	STER-reclames
ZZP-er	zzp'er
isbn	ISBN
sjieker	chiquer
moederdagkado	moederdagcadeau
ZZP-ers	zzp'ers
koppelstrepen	koppeltekens
kraamkado	kraamcadeau
ZMOK	zmok
kado's	cadeaus
klassediagrammen	klassendiagram
ISBN-nr.	ISBN
Cites-conferentie	CITES-conferentie
oo-serieux	au sérieux
RIAGG	Riagg
kadopapier	cadeaupapier
Bosnië-Herzegovina	Bosnië en Herzegovina
realiestieser	realistischer
burokratische	bureaucratische
de`s	dat is
kerstkado	kerstcadeau
febo	FEBO
technieker	technicus
kerstkadootje	kerstcadeautje
dermatologist	dermatoloog
verjaardagskadootje	verjaardagscadeautje
3-weekse	drieweekse
pvv-ers	PVV'ers
deurs	tweedeurs
jetten	jetskiën
Povray	POV-Ray
van zinnens zijn	zinnens zijn
ict-ers	ICT'ers
vvd-er	VVD'er
Cites-verdrag	CITES-verdrag
disseminating	disseminerend
ict-er	ICT'er
PDF-je	pdf'je
kadobonnen	cadeaubonnen
kado	cadeau
MBO-ers	mbo'ers
kadootje	cadeautje
keiweek	KEI-week
smtp-account	SMTP-account
kleuterleid	kleuterleidster
vvd-ers	VVD'ers
kados	cadeaus
paswoordgegevens	wachtwoordgegevens
afscheidskado	afscheidscadeau
één-op-één	een-op-een
kerstkadootjes	kerstcadeautjes
vvders	VVD'ers
ster-reclames	STER-reclames
mond-aan-mond-reclame	mond-tot-mondreclame
kadotje	cadeautje
boogywoogy	boogiewoogie
kadobon	cadeaubon
ster-reclame	STER-reclame
fbook	Facebook
verjaardagskado	verjaardagscadeau
ships	tallships
kiet	quitte
kadotjes	cadeautjes
slotevent	slotevenement
caissie`re	kassière
sjieke	chique
Cites	CITES
Natin	NATIN
kadoo	cadeau
Liège	Luik
kadoos	cadeaus
Hawaiians	Hawaïanen
tiglassen	TIG-lassen
gelijkheidwaardigheid	gelijkwaardigheid
kluppie	clubje
kadootjes	cadeautjes
Straat van Otranto	Kanaal van Otranto
vvder	VVD'er
OV-capaciteit	ov-capaticeit
BABS	babs
Jantje van Leiden	jantje-van-leiden
milieuefficiency	milieuefficiëntie
DVD`s	dvd's
fant	fantasie
Brinnummer	BRIN-nummer
MBO-er	mbo'er
passports	paspoorten
koppelstreep	koppelteken
actievieten	activiteiten
be`ta-studies	bètastudies
mri	MRI
BTW-behandeling	btw-behandeling
ict-sector	ICT-sector
BTW-richtlijn	btw-richtlijn
BTW-schade	btw-schade
Friendship	Vriendschap
FTP-server	ftp-server
cado	cadeau
beschimperd	beschimpt
nie`t	níét
BTW-maatregelen	btw-maatregelen
zééééér	zéér
BTW-vrij	btw-vrij
fotocopy	fotokopie
BTW-nultarief	btw-nultarief
disseminate	dissemineren
politburo	politbureau
ZZP'ers	zzp'ers
BTW-verplichting	btw-verplichting
pvv'er	PVV'er
pizzahut	Pizza Hut
heppie	heb je
ict-beleid	ICT-beleid
BTW-aftrek	btw-aftrek
ict-infrastructuur	ICT-infrastructuur
BTW-ontduiking	btw-ontduiking
burootje	bureautje
BTW-regeling	btw-regeling
chicque	chic
plugged	plugt
MKB-vrijstelling	mkb-vrijstelling
BTW-richtlijnen	btw-richtlijnen
pvda-ers	PvdA'ers
ict-voorzieningen	ICT-voorzieningen
burocratische	bureaucratische
versnellingskes	versnellinkjes
coo	COO
Asus	ASUS
DJ`s	dj's
Klassiekarabisch	klassiek Arabisch
zodan	zoals
burootjes	bureautjes
Jehovagetuige	Jehova's getuige
ZZP	zzp
BTW-afdrachten	btw-afdrachten
berstens	berstensvol
BTW-bedragen	btw-bedragen
oo-sérieux	au sérieux
dingske	dingetje
XTC-pil	xtc-pil
architectenburo	architectenbureau
usb	USB
drie-en-een-half	drie en een half
BTW-kosten	btw-kosten
Ster-reclame	STER-reclame
PDF	pdf
bed-bad-en-brooddiscussie	bed-bad-brooddiscussie
BTW-	btw-
steengrillert	steengrill
BTW-aangiftes	btw-aangiftes
BTW-percentage	btw-percentage
BTW-uitgaven	btw-uitgaven
maggie	mag hij
PDF-bestand	pdf-bestand
ipv	i.p.v.
BTW-problematiek	btw-problematiek
rozelgel	rozengelei
ict-toepassing	ICT-toepassing
BTW-bepalingen	btw-bepalingen
verantwoordelekheit	verantwoordelijkheid
effici	efficiënt
BTW-compensatie	btw-compensatie
BTW-controlekantoor	btw-controlekantoor
BTW-tarief	btw-tarief
consultatieburo	consultatiebureau
be`ta-opleidingen	bètaopleidingen
pastoren	pastoors
pvdaer	PvdA'er
gebant	gebannen
ict-budgetten	ICT-budgetten
toegejuigd	toegejuicht
BTW-verplichtingen	btw-verplichtingen
uitzendburo	uitzendbureau
Quijote	Quichot
vvd'er	VVD'er
Tsjchinvali	Tsinvali
BTW-gegevens	btw-gegevens
url's	URL's
BTW-activiteit	btw-activiteit
usb-stick	USB-stick
BTW-lasten	btw-lasten
talmud	Talmoed
Ster-reclames	STER-reclames
BTW-declaraties	btw-declaraties
maseuren	masseurs
hìj	hí́ȷ
meerdermalen	meermalen
zeven-en-een-half	zeven en een half
ict-bedrijf	ICT-bedrijf
tekeningskes	tekeningetjes
ict-gebied	ICT-gebied
Aldi	ALDI
ict-budget	ICT-budget
PDF's	pdf's
cadootjes	cadeautjes
url	URL
ict-vaardigheid	ICT-vaardigheid
ict-systeem	ICT-systeem
rsi-klachten	RSI-klachten
ZZP'er	zzp'er
ict-coördinator	ICT-coördinator
vvd'ers	VVD'ers
mongeaul	mongool
XTC-onderzoek	xtc-onderzoek
ict-coach	ICT-coach
FTP-site	ftp-site
BTW-voordeel	btw-voordeel
politieburo	politiebureau
attacks	attaques
burostoel	bureaustoel
PDF-bestanden	pdf-bestanden
BTW-gelden	btw-gelden
tweeëneenhalf	tweeënhalf
kommisje	commissie
BTW-sfeer	btw-sfeer
twee-en-een-half	twee en een half
BTW-factuur	btw-factuur
jìj	jí́ȷ
incassoburo's	incassobureaus
XTC-koeriers	xtc-koeriers
BTW-compensatieregeling	btw-compensatieregeling
BTW-inkomsten	btw-inkomsten
burlesque	burlesk
BTW-samenwerkingsverbanden	btw-samenwerkingsverbanden
BTW-aangiften	btw-aangiften
BTW-carrousel	btw-carrousel
BTW-betalingen	btw-betalingen
BTW-aangifte	btw-aangifte
XTC-zaken	xtc-zaken
Onderzoeklokatie	Onderzoekslocaties
BTW-comité	btw-comité
BTW-regime	btw-regime
BTW-grondslag	btw-grondslag
BTW-loket	btw-loket
BTW-reparatie	btw-reparatie
BTW-plichtigheid	btw-plichtigheid
ict-project	ICT-project
PDF-documenten	pdf-documenten
XTC-transporten	xtc-transporten
ict-activiteiten	ICT-activiteiten
zovéél	zóveel
27mc	27 MC
BTW-identificatienummers	btw-identificatienummers
kangaroo	kangoeroe
XTC-productie	xtc-productie
BTW-heffing	btw-heffing
dna-onderzoek	DNA-onderzoek
zwelde	zwol
stukkend	stukgaand
telefonen	telefoons
ict-component	ICT-component
BTW-vrijstelling	btw-vrijstelling
Salaì	Salaino
kunstenaren	kunstenaars
vic	VIC
carri	carrière
milieu-en	milieus
waarschiklijn	waarschijnlijk
BTW-administratie	btw-administratie
vééééél	véél
voorals	vooralsnog
issie	is hij
jop	JOP
BTW-regelgeving	btw-regelgeving
reisburo's	reisbureaus
BTW-lease	btw-lease
BTW-pakket	btw-pakket
BTW-nummer	btw-nummer
OV-chipcard	OV-chipkaart
ict-projecten	ICT-projecten
burkah	boerka
stukkende	stukgaande
handelsbarrie`res	handelsbarrière
afdalingskes	afdalinkjes
BTW-Compensatiefonds	Btw-compensatiefonds
ict-vergoeding	ICT-vergoeding
BTW-afdracht	btw-afdracht
buro's	bureaus
frankskes	franken
pvda-er	PvdA'er
pati	patiënt
carierre	carrière
BTW-plichtigen	btw-plichtigen
dingskes	dingetjes
koppie	kop
usb-poort	USB-poort
XTC-misdrijf	xtc-misdrijf
slachttanden	slagtanden
kangaroos	kangoeroes
ict-scholing	ICT-scholing
surseillance	surseance
BTW-middelen	btw-middelen
usb-sticks	USB-sticks
BTW-maatregel	btw-maatregel
oo serieux	au sérieux
sponsorships	sponsorschap
XTC-misdrijven	xtc-misdrijven
sint-bernhardhondjes	sint-bernardshondje
vrijheidsstelling	invrijheidstelling
BTW-verrekening	btw-verrekening
gilles-de-la-tourettesyndroom	gillesdelatourettesyndroom
state-of-the-art	state of the art
BTW-strategie	btw-strategie
BTW-informatie	btw-informatie
mond-aan-mondreclame	mond-tot-mondreclame
voorzorgsmaatregelingen	voorzorgsmaatregelen
hemmetjes	hemdjes
mond-op-mond-reclame	mond-tot-mondreclame
BTW-systeem	btw-systeem
XTC-aanpak	xtc-aanpak
zóóóó	zó
strakkies	straks
BTW-druk	btw-druk
BTW-regelingen	btw-regelingen
XTC-pillen	xtc-pillen
westfriese	West-Friese
FTP	ftp
buro	bureau
BTW-Comité	Btw-comité
accomodation	accommodatie
BTW-tariefverlaging	btw-tariefverlaging
afdalingske	afdalinkje
cariërre	carrière
BTW-tarieven	btw-tarieven
rsi	RSI
XTC-zaak	xtc-zaak
adviesburo	adviesbureau
BTW-plichtig	btw-plichtig
MKB-vrijstellingen	mkb-vrijstellingen
XTC-smokkel	xtc-smokkel
angstverwekkend	angstwekkend
katastrophe	catastrofe
ict-beleidsplan	ICT-beleidsplan
slachttand	slagtand
BTW-eenheid	btw-eenheid
be`ta-vakken	bètavakken
BTW-ondernemer	btw-ondernemer
westfriesland	West-Friesland
BTW-ontvangsten	btw-ontvangsten
reclameburo	reclamebureau
afrees	afreisde
usb-stickje	USB-stickje
vier-en-een-half	vier en een half
BTW-plicht	btw-plicht
XTC-laboratorium	xtc-laboratorium
PDF-versie	pdf-versie
BTW-code	btw-code
ict-producten	ICT-producten
ict-specialisten	ICT-specialisten
Phoeniciërs	Feniciërs
XTC-lab	xtc-lab
Febo	FEBO
zes-en-een-half	zes en een half
Joeri van Gelder	Yuri van Gelder
usb-kabel	USB-kabel
ivm	i.v.m.
zooo	zó
d`r	haar
tig-lassen	TIG-lassen
zìjn	zí́ȷn
onderzoeksburo	onderzoeksbureau
XTC-tabletten	xtc-tabletten
achterloos	achterlijk
BTW-fraude	btw-fraude
bed-bad-en-brooddiscussies	bed-bad-brooddiscussies
ict-beheerders	ICT-beheerders
spinnenrag	spinrag
gebrusqueerd	gebruuskeerd
mir	MIR
friendship	vriendschap
XTC-groep	xtc-groep
wienersnitsel	wienerschnitzel
burocratie	bureaucratie
ict-coaches	ICT-coaches
bulo	BuLO
ict-problemen	ICT-problemen
pie`ces	pièce
BTW-ondernemers	btw-ondernemers
BTW-attest	btw-attest
ict-afdeling	ICT-afdeling
BTW-opbrengst	btw-opbrengst
LEDjes	ledjes
BTW-compensatiefonds	btw-compensatiefonds
BTW-doeleinden	btw-doeleinden
burocraten	bureaucraten
BTW-bedrag	btw-bedrag
XTC-markt	xtc-markt
buros	bureaus
BTW-wetgeving	btw-wetgeving
BTW-nummers	btw-nummers
ict	ICT
Jehovagetuigen	Jehova's getuigen
XTC-beleid	xtc-beleid
BTW-verlaging	btw-verlaging
mìjn	mí́ȷn
pvdaers	PvdA'ers
BTW-kantoor	btw-kantoor
BTW-stelsel	btw-stelsel
talmudisten	Talmoedisten
altijdgroenend	altijdgroen
reisburo	reisbureau
BTW-verhoging	btw-verhoging
burqa	boerka
pvv'ers	PVV'ers
1m30	1,30 m
daagskes	dagjes
enqu	enquête
BTW-plichtige	btw-plichtige
BTW-regels	btw-regels
ict-basisvaardigheden	ICT-basisvaardigheden
laptoppen	laptops
BTW-claims	btw-claims
BTW-constructies	btw-constructies
BTW-constructie	btw-constructie
gemakske	gemak
buroblad	bureaublad
westend	West End
BTW-opbrengsten	btw-opbrengsten
febru	februari
Paluees	Paulus
burka-verbod	boerkaverbod
usb-aansluiting	USB-aansluiting
checkboekje	chequeboekje
ict-competenties	ICT-competenties
sp-er	SP'er
PDF-document	pdf-document
sp-ers	SP'ers
BTW-middel	btw-middel
BTW-instrument	btw-instrument
ict-vacatures	ICT-vacatures
Klassiekarabische	klassiek Arabische
burocratisch	bureaucratisch
ict'er	ICT'er
koptelefonen	koptelefoons
BTW-belaste	btw-belaste
FTP-sites	ftp-sites
XTC-achtig	xtc-achtig
ict-systemen	ICT-systemen
uitzendburo's	uitzendbureaus
stemburo	stembureau
t.e.m	t/m
attack	attaque
gewelden	gewelddaden
BTW-correctie	btw-correctie
ict-toepassingen	ICT-toepassingen
ict-apparatuur	ICT-apparatuur
cadootje	cadeautje
geband	gebannen
mìj	mí́ȷ
XTC-handel	xtc-handel
ict-bedrijven	ICT-bedrijven
wijte	weet
BTW-vrijstellingen	btw-vrijstellingen
Scandinavian	Scandinavisch
XTC-gebruik	xtc-gebruik
hellingske	hellinkje
ict'ers	ICT'ers
BTW-teruggave	btw-teruggave
wienersnitsels	wienerschnitzels
BTW-component	btw-component
arbeidsburo	arbeidsbureau
ict-vaardigheden	ICT-vaardigheden
gejuigd	gejuicht
vvd	VVD
nonsense	no-nonsense
ict-werkplekken	ICT-werkplekken
kho	KHO
BTW-kwestie	btw-kwestie
Phoeniciër	Feniciër
BTW-identificatienummer	btw-identificatienummer
incassoburo	incassobureau
usb-poorten	USB-poorten
Saint Laurent du Maroni	Saint-Laurent-du-Maroni
da`s	dat is
huuske	huisje
400m2	400 m²
premie`re	première
samuraizwaard	samoeraizwaard
door-en-door	door en door
d`huez	d'Huez
donateuren	donateurs
reïntegratiesubsidies	re-integratiesubsidies
stereotiepen	stereotypen
reïntegratieplicht	re-integratieplicht
paneuropees	pan-Europees
burka	boerka
coq-au-vin	coq au vin
noordzuid-verbindingen	noord-zuidverbindingen
gosjepietje	gossiepietje
railing	reling
pie`ce	pièce
verwijzigingen	verwijzingen
consierge	conciërge
retraining	hertraining
aan`t	aan 't
stukkies	stukjes
reïntegratiepraktijk	re-integratiepraktijk
be`ta	bèta
17m2	17 m²
gl'ers	GL'ers
voorzicht	voorzichtig
dìe	díé
reïntegratieovereenkomsten	re-integratieovereenkomsten
revisieïnformatie	revisie-informatie
questie	kwestie
KI	ki
Hadewych	Hadewijch
Wiener schnitzel	wienerschnitzel
OV-infrastructuur	ov-infrastructuur
retrain	hertrain
superdeluxe	super-de-luxe
geerft	geërfd
ze`lf	zélf
luiaarden	luiaards
Oost-Westverbinding	oost-westverbinding
reïntegratiemonitor	re-integratiemonitor
plekskes	plekjes
OV-jaarkaarthouders	ov-jaarkaarthouders
communities	community's
tenwiji	terwijl
barri`ere	barrière
reïntegreren	re-integreren
muurbeschilderingen	muurschilderingen
monopolypositie	monopoliepositie
zaakske	zaakje
reïntegratieverantwoordelijkheid	re-integratieverantwoordelijkheid
soppie	sopje
gebrepen	begrepen
reïntegratiekansen	re-integratiekansen
-weggejorist-	weggejorist
la`	lá
noordzuid-banen	noord-zuidbanen
orchestreren	orkestreren
reïntegratievraag	re-integratievraag
1.000m2	1.000 m²
OV-alternatieven	ov-alternatieven
10m3	10 m³
brugske	brugje
meeladres	mailadres
juigen	juichen
reïntegrerend	re-integrerend
bergske	bergje
waarrempel	warempel
eau-de-vies	eau de vies
reïntegratieovereenkomst	re-integratieovereenkomst
reïntegratietraject	re-integratietraject
passport	paspoort
europarlementariers	Europarlementariërs
gewordende	wordende
reïntegratiemaatregelen	re-integratiemaatregelen
o`	ó
OV-kaarten	ov-kaarten
github	GitHub
googelaar	goochelaar
hakkies	hakjes
we`l	wél
hyperuricaemie	hyperurikemie
Vanales	Van alles
mòet	móét
genânt	gênant
carrie`res	carrières
OV-knooppunt	ov-knooppunt
snitzel	schnitzel
na`	ná
OV-kaart	ov-kaart
barri`ereweerstanden	barrièreweerstanden
noordzuid-verbinding	noord-zuidverbinding
kerkske	kerkje
pvda'er	PvdA'er
treener	trainer
howdo	houdoe
he`	hè
handenspandiensten	hand-en-spandiensten
burkavrouwen	boerkavrouwen
zi	z.i.
Da`t	Dát
houmous	hummus
algorithms	algoritmes
Down-syndroom	downsyndroom
geken	gekeken
coënzym	co-enzym
Be`ta	Bèta
orchestrale	orkestrale
s`avonds	's avonds
bankske	bankje
catastrophe	catastrofe
helloween	Halloween
carrie`re	carrière
trener	trainer
landgoeden	landgoederen
cre`ches	crèches
reïntegratiewerkzaamheden	re-integratiewerkzaamheden
reïntegratiepakket	re-integratiepakket
Halloween-tocht	halloweentocht
OV-knooppunten	ov-knooppunten
12m2	12 m²
reïntegratievoorzieningen	re-integratievoorzieningen
anemieke	Annemieke
uberhaubt	überhaupt
Oostfriese	Oost-Friese
reïntegratietaken	re-integratietaken
naäpers	na-apers
koekske	koekje
gezèt	gézet
OV-gebruik	ov-gebruik
de`	dé
ondernemening	onderneming
beroepsexam	beroepsexamen
it	IT
anti-Amerikanisme	antiamerikanisme
hòe	hóé
burkadraagsters	boerkadraagsters
OV-beleid	ov-beleid
2m3	2 m³
zéééér	zéér
WOII-heden	WO II-helden
Poppies	Popjes
genomende	genoemde
TIO	Tio
klupje	clubje
be`taprofielen	bètaprofielen
bakske	bakje
5000m2	5000 m²
3m2	3 m²
dagske	dagje
Ampe`re	Ampère
reïntegratieverslagen	re-integratieverslagen
herkapitaliseerd	geherkapitaliseerd
150m2	150 m²
OV-jaarkaart	ov-jaarkaart
noordzuid-as	noord-zuidas
14m2	14 m²
Wob-procedure	WOB-procedure
reïntegratieopdrachten	re-integratieopdrachten
reïntegratieproducten	re-integratieproducten
Bargercompascuum	Barger-Compascuum
samuraiklasse	samoeraiklasse
rugske	rugje
OV-bussen	ov-bussen
kangaroe	kangoeroe
reflexie	reflectie
zeeëgeltje	zee-egeltje
zlotie	zloty
eaux-de-vie	eaux de vie
lintenbebouwing	lintbebouwing
verwachtigingen	verwachtingen
Ebola-virus	ebolavirus
tragediënnes	tragédiennes
elton-john-bril	eltonjohnbril
creditcrisis	kredietcrisis
klup	club
ondermeningen	ondernemingen
pé	pee
reïntegratiepremie	re-integratiepremie
koerswijzingen	koerswijzigingen
Westfriesland	West-Friesland
Westeuropese	West-Europese
loor	teloor
carrie`reperspectief	carrièreperspectief
genomend	genoemd
hartenkwaliteit	hartkwaliteit
sint-bernhardhond	sint-bernardshond
mond-tot-mondbeademing	mond-op-mondbeademing
noordzuid-richting	noord-zuidrichting
veelbetekend	veelbetekenend
zoëven	zo-even
sappie	sapje
burka's	boerka's
da`n	dán
Wob-verzoek	WOB-verzoek
achtneming	inachtneming
geïntregeerd	geïntegreerd
consierges	conciërges
doekske	doekje
nobelprijs-winnaar	Nobelprijswinnaar
1m3	1 m³
100m2	100 m²
truukjes	trucjes
500m2	500 m²
deïnstallatie	de-installatie
boodschappies	boodschapjes
gaaike	gaaitje
OV-jaarkaarten	ov-jaarkaarten
reïntegratieprogramma	re-integratieprogramma
nìets	níéts
truuks	trucs
OV-bedrijf	ov-bedrijf
Trans-Kaukasië	Transkaukasië
be`tastudies	bètastudies
broekske	broekje
opleidi	opleiding
We`l	Wél
Balkenende-norm	balkenendenorm
orchestratie	orkestratie
ploegske	ploegje
wetswijzingen	wetswijzigingen
carameliseren	karamelliseren
e`lke	élke
ruggegraad	ruggengraat
statiebezoek	staatsiebezoek
20m3	20 m³
gevallende	gevallen
oogskes	oogjes
reïntegratieplan	re-integratieplan
1000m2	1000 m²
catastrophes	catastrofes
quest	queeste
ov-capaticeit	ov-capaciteit
populatiegevens	populatiegegevens
dalijk	dadelijk
Phytophtora	phytophthora
dutskes	dutjes
potske	potje
OV-gebruikers	ov-gebruikers
plekkies	plekjes
statiefoto	staatsiefoto
s`nachts	's nachts
cre`che	crèche
carièrre	carrière
onwelwillig	ongewillig
weekskes	weekjes
inflectie	inflexie
handelsattachee	handelsattaché
Sp-er	SP'er
reïntegreerbaarheid	re-integreerbaarheid
truukje	trucje
industries	industrieën
ziekskes	ziekjes
keuning	koning
uitwijden	uitweiden
begonde	begon
noodle	noedel
haemorrhagie	hemorragie
Wob-informatie	WOB-informatie
erch	erg
armoedepijl	armoedepeil
sint-bernhardhondje	sint-bernardshondje
risico-niveau's	risiconiveaus
intra-reproduceerbaarheids-variatiecoëfficiënt	intrareproduceerbaarheidsvariatiecoëfficiënt
practicantenregeling	praktikantenregeling
hoekske	hoekje
OV-abonnementen	ov-abonnementen
OV-haltes	ov-haltes
reïntegratieverplichtingen	re-integratieverplichtingen
a.j.b.	ajb.
boekskes	boekjes
Westfriese	West-Friese
zowiezo	sowieso
cafe's	cafés
sex	seks
cre`me	crème
Wiener schnitzels	wienerschnitzels
bekkies	bekjes
vryheid	vrijheid
quint	kwint
noordzuid-lijnen	noord-zuidlijnen
nìet	níét
bergskes	bergjes
tijl	teil
afgelopende	afgelopen
reïntegratieproblematiek	re-integratieproblematiek
2cv	2CV
symphatisanten	sympathisanten
carrie`reverloop	carrièreverloop
vooruitstuwen	voortstuwen
OV-bedrijven	ov-bedrijven
be`ta's	bèta's
sexleven	seksleven
succe`s	succés
reïntegratiemethoden	re-integratiemethoden
viruses	virussen
sd	SD
gereïntegreerd	gere-integreerd
Jantje-van-Leiden	jantje-van-leiden
90m2	90 m²
vòòr	vóór
prodeanen	pro-Deanen
stekske	stekje
lobbies	lobby's
zakske	zakje
glaske	glaasje
OV-autoriteit	ov-autoriteit
inflecties	inflexies
mailingen	mailings
CV	cv
Hawaiian	Hawaïaan
lappie	lapje
gl-fractie	GL-fractie
Halloween-feest	halloweenfeest
belastingsdienst	Belastingdienst
noordzuid-route	noord-zuidroute
reïntegratiekosten	re-integratiekosten
vershuiste	verhuisde
Sponsorship	Sponsorschap
hobbies	hobby's
coupe's	coupés
reïntegratieregelingen	re-integratieregelingen
a`	à
Schottkytunnelbarri`ere	Schottkytunnelbarrière
barrie`rewerking	barrièrewerking
gelezende	gelezen
oerjoods	oer-Joods
reïntegratie-uitkering	re-integratie-uitkering
zloties	zloty's
vd	v.d.
barrie`res	barrières
reïntegratieprocessen	re-integratieprocessen
vis-a`-vis	vis-à-vis
flectie	flexie
reïntegreerbaar	re-integreerbaar
zeeëgels	zee-egels
reïntegratieproces	re-integratieproces
kakske	kakje
kippie	kipje
me`t	mét
OV-aanbod	ov-aanbod
Cis-Kaukasië	Ciskaukasië
reflexies	reflecties
barrie`re	barrière
excollegas	ex-collega's
zakskes	zakjes
Tweedekamer	Tweede Kamer
reïntegratieproject	re-integratieproject
hinkstapspringen	hink-stap-springen
reïntegratiebedrijf	re-integratiebedrijf
duitland	Duitsland
sint-bernhardhonden	sint-bernardshonden
5m2	5 m²
handelsattachees	handelsattachés
reïntegratietaak	re-integratietaak
reïntegratieresultaten	re-integratieresultaten
servie	Servië
rijkend	reikend
tamboermaître	tambour-maître
’sHertogenbosch	's-Hertogenbosch
knoppie	knopje
nicol	Nicole
kangaroes	kangoeroes
Wob-ambtenaren	WOB-ambtenaren
reïntegratieplannen	re-integratieplannen
reïntegratiebedrijven	re-integratiebedrijven
s`morgens	's morgens
hèèl	héél
Talmud	Talmoed
tis	't is
vrijheidstelling	invrijheidstelling
OV-halte	ov-halte
attache's	attachés
Onze Lieve Heer	Onze-Lieve-Heer
Sp-ers	SP'ers
reïntegratievisie	re-integratievisie
rijkende	reikende
OV-jaarabonnement	ov-jaarabonnement
zeeëgeltjes	zee-egeltjes
1000m3	1000 m³
intestate	intestaat
algorithm	algoritme
droppie	dropje
he`t	hét
grondwetswijzing	grondwetswijziging
reïntegratietrajecten	re-integratietrajecten
version	versie
georchestreerde	georkestreerde
reïntegrerende	re-integrerende
15m2	15 m²
hartenfunctie	hartfunctie
oo sérieux	au sérieux
weltruste	welterusten
be`taprofiel	bètaprofiel
brakwater-	brak water
reïntegratiemogelijkheden	re-integratiemogelijkheden
reïntegratiesector	re-integratiesector
vice-Premier	vicepremier
Tuva	Toeva
laisser passers	laissez-passers
dyslectie	dyslexie
vechtschijding	vechtscheiding
carrie`remogelijkheden	carrièremogelijkheden
mise`re	misère
geörienteerd	georiënteerd
remixing	remixen
e`n	én
vrolijkhijd	vrolijkheid
soeppie	soepje
sponsorship	sponsorschap
zwelden	zwollen
OV-exploitanten	ov-exploitanten
reïntegratietelefoon	re-integratietelefoon
penalties	penalty's
Februarij	februari
provisore	provisoir
hiëroglyfenschrift	hiërogliefenschrift
sp'er	SP'er
limericken	limericks
200m2	200 m²
bezoekske	bezoekje
carrie`re-	carrière-
zóóó	zó
abberant	aberrant
Ijsboereke	IJsboerke
internet-troll	internettrol
blokskes	blokjes
ja`	já
Tweedekamerleden	Tweede Kamerleden
dur	er
e`cht	écht
proffesionals	professionals
reïntegratiemaatregel	re-integratiemaatregel
reïntegratieverplichting	re-integratieverplichting
stekskes	stekjes
1m2	1 m²
georchestreerd	georkestreerd
OV-exploitatie	ov-exploitatie
Vòòr	Vóór
keukenkruid	keukenkruiden
barri`ereweerstand	barrièreweerstand
reïntegratiepogingen	re-integratiepogingen
ukkies	ukjes
Natùùrlijk	Natúúrlijk
reïntegratiebudgetten	re-integratiebudgetten
au-serieux	au sérieux
gedaande	gedane
eau-de-vie	eau de vie
reïntegratietoeslag	re-integratietoeslag
retrainen	hertrainen
preïndustriële	pre-industriële
OV-diensten	ov-diensten
monopoliegeld	monopolygeld
enquette	enquête
4m2	4 m²
reïntegratieverslag	re-integratieverslag
geemaild	ge-e-maild
be`ta-	bèta-
s`middags	's middags
Halloween-avond	halloweenavond
OV-abonnement	ov-abonnement
ka`n	kán
landtroep	landtroepen
statieportret	staatsieportret
MBO-raad	MBO Raad
koekskes	koekjes
wetswijzing	wetswijziging
poppies	popjes
ZDNET	ZDNet
laptoppie	laptopje
reïntegratiebudget	re-integratiebudget
kaske	kastje
poppie	popje
veelbetekende	veelbetekenende
door-de-weekse	doordeweekse
Westfries	West-Fries
blokske	blokje
vice-président	vicepresident
cariëre	carrière
paneuropese	pan-Europese
OV-autoriteiten	ov-autoriteiten
toejuigen	toejuichen
P.S.	PS
jeu-de-boules	jeu de boules
dertigersdillema	dertigersdilemma
hinkstapsprong	hink-stap-sprong
stijle	steile
ondernemeningen	ondernemingen
5m3	5 m³
dissemination	disseminatie
practicanten	praktikanten
éénzelfde	eenzelfde
companion	compagnon
reïntegratie	re-integratie
gèèn	géén
gejuig	gejuich
stokskes	stokjes
reïntegratiemiddelen	re-integratiemiddelen
op en top	op-en-top
6m3	6 m³
semi-ambtelijke	semiambtelijk
e`chte	échte
Wob-verzoeken	WOB-verzoeken
nix	niks
koppies	koppen
citohulp	Cito-hulp
practicant	praktikant
broodje-aap-verhalen	broodjeaapverhalen
crapule	crapuul
mèèr	méér
vinexlocaties	Vinex-locaties
òòk	óók
spagettie	spaghetti
reïntegratieondersteuning	re-integratieondersteuning
Tweede-Kamer-leden	Tweede Kamerleden
geörienteerde	georiënteerde
broodje-aap-verhaal	broodjeaapverhaal
proppie	propje
marktvertrouw	marktvertrouwen
nobelprijs-winnaars	Nobelprijswinnaars
Gene`ve	Genève
10m2	10 m²
terechtwijzigingen	terechtwijzingen
V.S.	VS
reïntegratieprojecten	re-integratieprojecten
trace's	tracés
rentegratie	re-integratie
300m2	300 m²
buikske	buikje
sociaalmedische	sociaal-medisch
gebleerd	geblèrd
cliente`le	clientèle
opentaal	OpenTaal
Snappie	Snap je
noordzuid-baan	noord-zuidbaan
bioinformatics	bio-informatica
da`t	dát
droppies	dropjes
sp'ers	SP'ers
milieu-effect-rapportage	milieueffectrapportage
gevolgende	gevolgen
pakskes	pakjes
zeeëgel	zee-egel
vinexwijken	Vinex-wijken
juig	juich
noordzuid-assen	noord-zuidassen
reïntegratiemarkt	re-integratiemarkt
vinexwijk	Vinex-wijk
reïntegratiekans	re-integratiekans
lekkerbekkies	lekkerbekjes
praatzaam	spraakzaam
quantum	kwantum
mondelijk	mondeling
stukskes	stukjes
reïntegratievoorziening	re-integratievoorziening
truuk	truc
afschuwlijke	afschuwelijk
daarvòòr	daarvóór
500m3	500 m³
kanaalzwemmert	Kanaalzwemmer
serviers	Serviërs
burkaverbod	boerkaverbod
bobbies	bobby's
cylinidervormig	cilindervormig
moskees	moskeeën
samurai	samoerai
burkavrouw	boerkavrouw
conan	canon
reïntegratie-uitkeringen	re-integratie-uitkeringen
dijood-gefunctionaliseerd	di-joodgefunctionaliseerd
ashkenazische	Asjkenazische
reïntegratiekandidaten	re-integratiekandidaten
youtube	YouTube
mond-op-mondreclame	mond-tot-mondreclame
herfststijlloos	herfsttijloos
boekske	boekje
id-bewijs	ID-bewijs
galle	challe
te`	té
wijdser	weidser
noordzuid-routes	noord-zuidroutes
deïnstalleren	de-installeren
pakkies	pakjes
tezijnertijd	te zijner tijd
bakskes	bakjes
Maria-Theresia	Maria Theresa
véééél	véél
be`tavakken	bètavakken
noordzuid-lijn	noord-zuidlijn
16m2	16 m²
europarlementarier	Europarlementariër
Ijzerenleen	IJzerenleen
skijackjes	ski-jackjes
plannin	planning
Wordfued	Wordfeud
stelstel	stelsel
genied	geniet
vice-ministers	viceministers
toendertijd	toentertijd
gedesinfecteerdt	gedesinfecteerd
sociaalethische	sociaal-ethische
samengesteldt	samengesteld
push-upbh's	push-up-bh's
wèl	wél
loco-burgemeester	locoburgemeester
honingraden	honingraten
herkenen	herkennen
paralelle	parallelle
gekneedt	gekneed
getilt	getild
beukenootjes	beukennootjes
gesneuvelt	gesneuveld
antiasthmatica	antiastmatica
uitzendbureau's	uitzendbureaus
geschaaft	geschaafd
gestrompeldt	gestrompeld
luske	lusje
zee-arm	zeearm
uitgehardt	uitgehard
vastgeschroeft	vastgeschroefd
Ijzerkotmolen	IJzerkotmolen
Ijsetrippers	IJsetrippers
noord-zuid-as	noord-zuidas
semi-openbare	semiopenbare
rug-belettering	rugbelettering
buter	Buter
jeugdlogie	jeugdlogies
rijnwater	Rijnwater
overheidsfinancien	overheidsfinanciën
afgesloofdt	afgesloofd
zóóveel	zóveel
truuken	truken
Ijburg	IJburg
burgelijke	burgerlijke
perscorps	perskorps
timon	Timon
onderdrukd	onderdrukt
broodje-aap	broodje aap
europarlementariër	Europarlementariër
investeringbeleid	investeringsbeleid
Africa's	Afrika's
interimperiode	interim-periode
uitgezonderdt	uitgezonderd
rens	Rens
Ticketbox	TicketBox
geborstelt	geborsteld
thuisvoelden	thuis voelden
bunde	bundel
christian-scientist	christian scientist
opgedroogdt	opgedroogd
USBstick	USB-stick
klasseverschil	klassenverschil
manoevreert	manoeuvreert
gekleeft	gekleefd
Ijzerstraat	IJzerstraat
getekent	getekend
softwar	software
kreatief	creatief
gewoont	gewoond
geluidgegevens	geluidsgegevens
azerty-klavier	azertyklavier
teruggebelt	teruggebeld
geïsoleert	geïsoleerd
gefotografeert	gefotografeerd
veroorzaakd	veroorzaakt
azerty-klaviertjes	azertyklaviertjes
gebauwdt	gebauwd
-zoveel	zoveel
gerustgesteldt	gerustgesteld
real time	realtime
pors	Pors
pitoreske	pittoreske
vossebes	vossenbes
gestimuleert	gestimuleerd
ja-woord	jawoord
genudt	genut
geknoeit	geknoeid
menieën	meniën
geleeft	geleefd
3cm	3 cm
zittinghebbende	zitting hebbende
in zake	inzake
diploma`s	diploma's
gedimt	gedimd
gewisselt	gewisseld
gezochd	gezocht
vice-premiers	vicepremiers
gedansd	gedanst
arts-patiënt-relatie	arts-patiëntrelatie
uitgestrooit	uitgestrooid
CO²	CO₂
medemogelijk	mede mogelijk
taluuds	taluds
genoemdt	genoemd
afgebeelt	afgebeeld
levenbeschouwelijke	levensbeschouwelijke
aanvals	aanvals-
aboriginals	Aboriginals
peterman	pieterman
8cm	8 cm
arende	arenden
concièrges	conciërges
gehousd	gehoused
slob	slop
Oranje-Vrijstaat	Oranje Vrijstaat
porsche	Porsche
mert	met
gedeeldt	gedeeld
o-ringen	O-ringen
uitgegroeit	uitgegroeid
geheit	geheid
gereflecteert	gereflecteerd
gemandt	gemand
Westelijke Duina	Westelijke Dvina
paardekastanjes	paardenkastanjes
allerei	allerlei
belangerijkste	belangrijkste
kort-geding	kortgeding
Ijdelheid	IJdelheid
bereit	bereid
gediscussieert	gediscussieerd
excollega's	ex-collega's
gezuivert	gezuiverd
aanbonsen	aanbonzen
Bussummer	Bussumer
gedroogden	gedroogde
formatieuitbreiding	formatie-uitbreiding
aangetoont	aangetoond
genaait	genaaid
koningsdag	Koningsdag
oostenrijk	Oostenrijk
gewaadt	gewaad
terpetijn	terpentijn
vessem	Vessem
doorgespeelt	doorgespeeld
attaché-koffertjes	attachékoffertjes
verantwoordelij	verantwoordelijk
soul-achtige	soulachtige
frans	Frans
WOI	WO I
geïdentificeert	geïdentificeerd
judoka`s	judoka's
opgetuigt	opgetuigd
gecentreerdt	gecentreerd
geobserveert	geobserveerd
CU-er	CU'er
groepsaccomodatie	groepsaccommodatie
boutste	boudste
Ijsselmeer	IJsselmeer
anti-rookwet	antirookwet
bezad	bezat
alluminium	aluminium
gekoelt	gekoeld
gerookd	gerookt
gekenmerkd	gekenmerkt
ingeburgert	ingeburgerd
kno arts	kno-arts
gebroedt	gebroed
aërodynamisch	aerodynamisch
-wij	wij
gevierdt	gevierd
geconstrueert	geconstrueerd
bij-effect	bijeffect
opgevoet	opgevoed
aikidoend	aikidoënd
boete's	boetes
gewandelt	gewandeld
milieu-effectiviteit	milieueffectiviteit
gediendt	gediend
gereviseert	gereviseerd
para-medicus	paramedicus
alluminiumfolie	aluminiumfolie
deva	Deva
souveniertjes	souvenirtjes
huiske	huisje
gevraagt	gevraagd
electriciteitsbedrijven	elektriciteitsbedrijven
gecombineert	gecombineerd
planbureau's	planbureaus
uitgespeelt	uitgespeeld
jodenhaat	Jodenhaat
milieu-overtredingen	milieuovertredingen
wankelmoter	wankelmotor
Milieuinspectie	Milieu-inspectie
ADHD-ers	ADHD'ers
schriftplaats	Schriftplaats
slechtse	slechtste
département	departement
quizzes	quizzen
G-spot	g-spot
bama-structuur	bamastructuur
gewichtdelen	gewichtsdelen
catharijne	Catharijne
waarbijde	waarbij de
etherpad	Etherpad
gehoondt	gehoond
beugelbh	beugel-bh
geverft	geverfd
evidence-based	evidencebased
getelt	geteld
belgenmoppen	Belgenmoppen
attaché-koffer	attachékoffer
Vinexlocaties	Vinex-locaties
politie-autoriteiten	politieautoriteiten
gecontroleert	gecontroleerd
milieuinspectie	milieu-inspectie
getaped	getapet
zèg	zég
klassepatiënten	klassenpatiënten
16jarige	16-jarige
caravanserais	karavanserais
gewichtdeel	gewichtsdeel
azaleas	azalea's
burgelijk	burgerlijk
politie-officier	politieofficier
vice-premier	vicepremier
geduurt	geduurd
zij-ingang	zijingang
gesjoemelt	gesjoemeld
zorgdraag	zorg draag
excollega	ex-collega
bêta	bèta
diagnose-apparatuur	diagnoseapparatuur
recruteerde	rekruteerde
ietskes	ietsjes
voor-stellen	voorstellen
13jarige	13-jarige
zègt	zégt
1mm	1 mm
dubbelcd-edities	dubbel-cd-edities
verwoesd	verwoest
lidtekenweefsel	littekenweefsel
zedendeliquenten	zedendelinquenten
pseudo-wetenschappen	pseudowetenschappen
gefabriceert	gefabriceerd
geblesseert	geblesseerd
top-5	top 5
qwerty-klavier	qwertyklavier
gelimiteerdt	gelimiteerd
ambulanc	ambulance
gestormt	gestormd
fourageren	foerageren
gecastreert	gecastreerd
gevuldt	gevuld
gevult	gevuld
geluit	geluid
gedient	gediend
priv	privé
uitgemoordt	uitgemoord
geadviseert	geadviseerd
bevrijt	bevrijd
spanende	spannende
aantaal	aantal
geklaagt	geklaagd
avondland	Avondland
klassebewustzijn	klassenbewustzijn
reincarneren	reïncarneren
televisieuitzendingen	televisie-uitzendingen
uitgedooft	uitgedoofd
1km	1 km
gecodeert	gecodeerd
gekundt	gekund
geroddelt	geroddeld
Ijzermans	IJzermans
gesjouwdt	gesjouwd
gespendeert	gespendeerd
opgeruimdt	opgeruimd
statenvergadering	Statenvergadering
uitgestuurt	uitgestuurd
emeritus-hoogleraar	emeritus hoogleraar
gezaait	gezaaid
nòch	nóch
Koninginnendag	Koninginnedag
euri's	euro's
verbrant	verbrand
enqueteurs	enquêteurs
getoondt	getoond
7kg	7 kg
monolitisch	monolithisch
geslaagdt	geslaagd
getwijfelt	getwijfeld
integratieuitkering	integratie-uitkering
boske	bosje
milieu-onvriendelijke	milieuonvriendelijke
oud-testamentische	oudtestamentische
uitgerokken	uitgetrokken
top-3	top 3
3miljoen	3 miljoen
gemolt	gemold
wiener schnitzel	wienerschnitzel
gebundelt	gebundeld
caf	café
geproeft	geproefd
coòrdinatie	coördinatie
uitgedoktert	uitgedokterd
controle's	controles
gesperdt	gesperd
gestyleerde	gestileerde
omgetovert	omgetoverd
pseudo-weduwe	pseudoweduwe
toezichtwerkzaamheden	toezichtswerkzaamheden
gecompenseerdt	gecompenseerd
uitgehuwelijkd	uitgehuwelijkt
móet	móét
opgespoort	opgespoord
Timo’s	Timo's
meegerekent	meegerekend
VVD-ers	VVD'ers
gehanteert	gehanteerd
gespod	gespot
bijvoorbeel	bijvoorbeeld
lokatie	locatie
gebouwdt	gebouwd
gehandeldt	gehandeld
heruitgaves	heruitgaven
knijn	konijn
18jarige	18-jarige
accupuncturist	acupuncturist
veda	Veda
enqueteformulieren	enquêteformulieren
electriciteitsleverancier	elektriciteitsleverancier
ingevuldt	ingevuld
bureaux	bureaus
naijlend	na-ijlend
cruiseship	cruiseschip
geborduurt	geborduurd
gedoopd	gedoopt
kommissie	commissie
american football	American football
gevoet	gevoed
azerty-toetsenbordje	azertytoetsenbordje
bedachdt	bedacht
gegooit	gegooid
aëroob	aeroob
75+-ers	75+'ers
maasvlakte	Maasvlakte
Nieuw Nickerie	Nieuw-Nickerie
3maanden	3 maanden
verwerkd	verwerkt
vastgelegt	vastgelegd
wardoor	waardoor
ingeruilt	ingeruild
meegestuurt	meegestuurd
politiecorps	politiekorps
bedrijfstroom	bedrijfsstroom
toegezegt	toegezegd
milieu-autoriteiten	milieuautoriteiten
brommert	brommer
mutske	mutsje
bemensd	bemenst
inhaalmanoevre	inhaalmanoeuvre
opgefrisd	opgefrist
smartwatche	smartwatches
geoxideerdt	geoxideerd
volkenbond	Volkenbond
cassière	caissière
geledende	geldende
opgestard	opgestart
gemelt	gemeld
opgesteldt	opgesteld
paralel	parallel
voedingsupplementen	voedingssupplementen
derdegeneratie	derde generatie
opschoningwerkzaamheden	opschoningswerkzaamheden
getypten	getypte
gecharmeert	gecharmeerd
verbeelt	verbeeld
opgaveformulieren	opgavenformulieren
gedoseert	gedoseerd
20jarige	20-jarige
judoen	judoën
-wereld	wereld
tòch	tóch
gedachtensprongen	gedachtesprongen
waardenlijst	waardelijst
buls	Buls
recruteert	rekruteert
gemeniriken	gemeneriken
gezint	gezind
opgemerkd	opgemerkt
gezegent	gezegend
teruggeweest	terug geweest
teruggestuurt	teruggestuurd
getraindt	getraind
gespeent	gespeend
grenslogie	grenslogies
gebloemt	gebloemd
neergestord	neergestort
wiener schnitzels	wienerschnitzels
jeremiëerde	jeremieerde
prijske	prijsje
-zonder	zonder
gestofzuigt	gestofzuigd
bioinformatica	bio-informatica
opengescheurdt	opengescheurd
teruggeschroeft	teruggeschroefd
beschermingsniveau's	beschermingsniveaus
getoont	getoond
semi-militaire	semimilitaire
strafrechterlijke	strafrechtelijke
electra	elektra
geoefent	geoefend
geveilt	geveild
gestrooit	gestrooid
apenootjes	apennootjes
croque madames	croque-madames
noordzuidlijn	noord-zuidlijn
Ijzertoren	IJzertoren
vulcanoloog	vulkanoloog
geruilt	geruild
ingevoegt	ingevoegd
D66-er	D66'er
winaars	winnaars
gesitueert	gesitueerd
no-fly-zones	no-flyzones
geveegt	geveegd
antidiscriminatiebureau's	antidiscriminatiebureaus
wìllen	wíllen
sat	dat
elp	Elp
hightea-etagère	highteaetagère
noires	noirs
belastingsbrief	belastingbrief
dese	deze
semi-legale	semilegale
toegewijdt	toegewijd
hoffmann	Hoffmann
sneak peek	sneakpeek
gedooft	gedoofd
gefantaseerdt	gefantaseerd
gemaait	gemaaid
kùnnen	kúnnen
aangespoort	aangespoord
ex-collegas	ex-collega's
feërieke	feeërieke
beled	belet
type's	types
bristol	Bristol
politie-agent	politieagent
tergelijkertijd	tegelijkertijd
Co2-uitstoot	CO2-uitstoot
geprojecteert	geprojecteerd
gerealiseert	gerealiseerd
hindoees	hindoes
au serieux	au sérieux
semi-autobiografische	semiautobiografische
chateau's	chateaus
aangesteldt	aangesteld
ànderen	ánderen
klippel	Klippel
dieze	die ze
genestelt	genesteld
herre	Herre
crême	crème
neude	Neude
vinex	Vinex
elfstedenstad	Elfstedenstad
moslems	moslims
bepleidt	bepleit
coulissenlandschap	coulisselandschap
ingehuurt	ingehuurd
honingraad	honingraat
politie-onderwijs	politieonderwijs
tentoongespreidt	tentoongespreid
stortlokatie	stortlocatie
caramelliseren	karamelliseren
kantinekommissie	kantinecommissie
manouvres	manoeuvres
zorginformatieuitwisseling	zorginformatie-uitwisseling
wìl	wíl
ekende	bekende
manouvreren	manoeuvreren
gerooit	gerooid
geaccepteert	geaccepteerd
karameliseren	karamelliseren
oud-oom	oudoom
gebruikd	gebruikt
Edelweis	Edelweiss
camera`s	camera's
koerswinstverhouding	koers-winstverhouding
gies	Gies
rechtergrafiek	rechter grafiek
spagetti	spaghetti
vertolkd	vertolkt
verversd	ververst
omd	om
7mm	7 mm
pseudo-wetgeving	pseudowetgeving
deeltijdsaanstellingen	deeltijdaanstellingen
inderdaat	inderdaad
opgeschroeft	opgeschroefd
vice-presidentschap	vicepresidentschap
WOIII	WO III
opgewaardeert	opgewaardeerd
discjockeys	diskjockeys
gelezend	gelezen
geërgerdt	geërgerd
bureau's	bureaus
koppe	koppen
voorzittert	voorzitter
valent	Valent
gereleased	gereleaset
betrapd	betrapt
gefundeert	gefundeerd
schrijvert	schrijver
geneukdt	geneukt
opgaveverplichting	opgavenverplichting
gezichd	gezicht
informatie-aanvragen	informatieaanvragen
gekerft	gekerfd
muziekaal	muzikaal
STER-reclame's	STER-reclames
genuanceert	genuanceerd
aangestuurdt	aangestuurd
moederstaal	moedertaal
wereldhandelsorganisatie	Wereldhandelsorganisatie
zònder	zónder
omgekleedt	omgekleed
jaarlijk	jaarlijks
Ijanuari	januari
gegenereert	gegenereerd
glooing	glooiing
Bijiage	Bijlage
gescheurt	gescheurd
0m	0 m
verstandkies	verstandskies
-wat	wat
afgehandelt	afgehandeld
deeltijdsfuncties	deeltijdfuncties
geschreidt	geschreid
gehindert	gehinderd
tòt	tót
bonde	blonde
6-cylinder	6-cilinder
faecaaloccultbloedtest	fecaaloccultbloedtest
afgeschildert	afgeschilderd
gascylinders	gascilinders
politie-ambtenaar	politieambtenaar
vastgelijmdt	vastgelijmd
zòveel	zóveel
afgebouwt	afgebouwd
gemonteerdt	gemonteerd
wereldschaakbond	Wereldschaakbond
eigengewin	eigen gewin
2meter	2 meter
opgestelt	opgesteld
sovjetperiode	Sovjetperiode
6kg	6 kg
niveau's	niveaus
invrijheidsstellingen	invrijheidstellingen
weggehaalt	weggehaald
gerekent	gerekend
getoetsd	getoetst
uitgeprobeert	uitgeprobeerd
kangoo	Kangoo
4m	4 m
geëindigt	geëindigd
hitlergroet	Hitlergroet
6m	6 m
geïnspireert	geïnspireerd
gesubsidieerdt	gesubsidieerd
gesorteert	gesorteerd
2-cylinder	2-cilinder
UML-klassediagram	UML-klassendiagram
dichtgeslibt	dichtgeslibd
deeltijdsaanstelling	deeltijdaanstelling
betablokkers	bètablokkers
bolleman	Bolleman
4miljoen	4 miljoen
geïnspecteerdt	geïnspecteerd
gecompenseert	gecompenseerd
baand	baan
6km	6 km
Zo`n	Zo'n
paanakker	Paanakker
parallele	parallelle
verblijt	verblijd
karaker	karakter
ontaart	ontaard
gebaseerdt	gebaseerd
weggebrandt	weggebrand
geresolveert	geresolveerd
croque monsieur	croque-monsieur
reddingwerk	reddingswerk
tre	te
afgelevert	afgeleverd
-want	want
gerechtvaardigt	gerechtvaardigd
nieuwbouwlokaties	nieuwbouwlocaties
radaartje	radartje
gedeklasseerd	gedeclasseerd
lendedoek	lendendoek
goeien	goeden
beantwoort	beantwoord
afgehandeldt	afgehandeld
opgejaagt	opgejaagd
gehonoreert	gehonoreerd
ingeschakeldt	ingeschakeld
subkommissie	subcommissie
geoffert	geofferd
afgespoelt	afgespoeld
0km	0 km
veda's	Veda's
rijksvoorlichtingsdienst	Rijksvoorlichtingsdienst
Tunesier	Tunesiër
gezondigt	gezondigd
mond-tot-mond-reclame	mond-tot-mondreclame
woonzorgzones	woon-zorgzones
palestijnen	Palestijnen
visserschip	vissersschip
kamerdebat	Kamerdebat
gefingeerdt	gefingeerd
gevoegdt	gevoegd
practisch	praktisch
slijmvlieirritatie	slijmvliesirritatie
geboort	geboord
geboeit	geboeid
huursubsidieuitgaven	huursubsidie-uitgaven
reuzachtig	reusachtig
komputerprogramma	computerprogramma
ìk	ík
geplaagt	geplaagd
aangestelt	aangesteld
50+ers	50+'ers
geindustrialiseerde	geïndustrialiseerde
gefrituurdt	gefrituurd
B&b	B&B
ontblood	ontbloot
gesiert	gesierd
defacto	de facto
gesoldeerdt	gesoldeerd
semi-gestructureerd	semigestructureerd
opengestelt	opengesteld
vice-directeur	vicedirecteur
opgedeelt	opgedeeld
geüploadt	geüpload
geaccordeerdt	geaccordeerd
werkingsfeer	werkingssfeer
gefocusd	gefocust
hagels	hagel
laisser faire	laisser-faire
welles-nietes-spel	welles-nietesspel
milieu-optiek	milieuoptiek
gestadt	gestat
opgaveformulier	opgavenformulier
geflansd	geflanst
lesies	laesies
koninginnedagen	Koninginnedagen
rijkswaterstaat	Rijkswaterstaat
semi-publieke	semipublieke
katastrofaal	catastrofaal
2mm	2 mm
ingegooidt	ingegooid
politie-aanwezigheid	politieaanwezigheid
raadsenquete	raadsenquête
afgehaalt	afgehaald
djogo	dyogo
gezakd	gezakt
turkije	Turkije
studio`s	studio's
gehuurdt	gehuurd
zij-instromers	zijinstromers
gefilmdt	gefilmd
housde	housede
politie-agenten	politieagenten
gestuurt	gestuurd
enquetecommissie	enquêtecommissie
gouds	Gouds
leasie	laesie
meegereist	meegereisd
gezagsvoerders	gezagvoerders
afgeleidt	afgeleid
winning mood	winningmood
gefaciliteert	gefaciliteerd
oost-west-richting	oost-westrichting
methet	met het
90km	90 km
defensieuitgaven	defensie-uitgaven
jeu-de-boule	jeu-de-boul
genuttigt	genuttigd
ingehaalt	ingehaald
Ijsselstein	IJsselstein
omgekeerdt	omgekeerd
taxie	taxi
politie-auto's	politieauto's
Faceboek	Facebook
informatie-achterstand	informatieachterstand
verledt	verlet
semi-collectieve	semicollectieve
20kHz	20 kHz
goeienmiddag	goeiemiddag
popijopie	popiejopie
vledder	Vledder
uitgebaad	uitgebaat
manoevre	manoeuvre
aangelegdt	aangelegd
extra`s	extra's
gerefereert	gerefereerd
milieu-overwegingen	milieuoverwegingen
sneak preview	sneakpreview
gemotiveert	gemotiveerd
ingenieursbureau's	ingenieursbureaus
schoollokaties	schoollocaties
geworstelt	geworsteld
aangescherpd	aangescherpt
vermelt	vermeld
Nù	Nú
smulweb	Smulweb
attaches	attachés
top-6	top 6
getagt	getagd
60+ers	60+'ers
ingevoerdt	ingevoerd
uitgespeeldt	uitgespeeld
ditjaar	dit jaar
compactdisc	compact disc
kòn	kón
ruimstestation	ruimtestation
geluidt	geluid
Dalì	Dalí
gedrilt	gedrild
gefiltert	gefilterd
thuisvoelde	thuis voelde
voltijdsfuncties	voltijdfuncties
genegeerdt	genegeerd
Ijzer	IJzer
niobe	Niobe
geprofiteert	geprofiteerd
gedomineert	gedomineerd
wèrkelijk	wérkelijk
gedoelt	gedoeld
uitgestalt	uitgestald
ng	nog
gebeldt	gebeld
quizz	quiz
lidteken	litteken
broodje-aapverhaal	broodjeaapverhaal
cruise-control	cruisecontrol
opgemaakd	opgemaakt
push-upbh	push-up-bh
uitgestippelt	uitgestippeld
maisonette	maisonnette
gespeeldt	gespeeld
Ijsland	IJsland
Vinex-lokaties	Vinex-locaties
ayatollah's	ayatollahs
rechtsspraak	rechtspraak
gekleet	gekleed
zeergeëerde	zeer geëerde
mer	met
rondgeleidt	rondgeleid
ingewijdt	ingewijd
Bosni	Bosnië
3mm	3 mm
geopereerdt	geopereerd
kayaks	kajaks
sms-te	sms'te
semi-overheidsorganisaties	semioverheidsorganisaties
tarwe-aren	tarwearen
geblendt	geblend
bekenen	bekennen
garante	garantie
uitgedroogt	uitgedroogd
dìt	dít
gooi-en-smijt-film	gooi-en-smijtfilm
rozenrevolutie	Rozenrevolutie
informatie-opslag	informatieopslag
vice-presidentsschap	vicepresidentsschap
-wie	wie
hypoglycaemie	hypoglycemie
berichd	bericht
gemen	gemeen
gebreit	gebreid
geconsumeert	geconsumeerd
monolitische	monolithische
gelunchd	geluncht
halal vlees	halalvlees
geduwdt	geduwd
toegestuurdt	toegestuurd
top-30	top 30
gerooft	geroofd
privé-audiëntie	privéaudiëntie
transscriptiefactoren	transcriptiefactoren
gepeldt	gepeld
brexit-referendum	brexitreferendum
geaccepteerdt	geaccepteerd
vacature's	vacatures
5mg	5 mg
kopiëerde	kopieerde
verplaatsd	verplaatst
seismo-akoestiek	seismoakoestiek
sneak-preview	sneakpreview
jazz-metropool	jazzmetropool
gemarkeert	gemarkeerd
belastingopgaves	belastingopgaven
popie-jopie	popiejopie
androidoprichter	Androidoprichter
uitkan	uit kan
periodeonderwjs	periodeonderwijs
ingebedt	ingebed
1mei	1 mei
andijviestampot	andijviestamppot
EtherPad	Etherpad
apentrots	apetrots
politie-operaties	politieoperaties
wienerschnitsels	wienerschnitzels
gekrabt	gekrabd
palmzondag	Palmzondag
eigenrisico	eigen risico
kijkert	kijker
zogezegde	zogezegd
uitgebuidt	uitgebuit
hulzebos	Hulzebos
noord-zuid-baan	noord-zuidbaan
gekwelt	gekweld
zogezegdt	zogezegd
omgewisselt	omgewisseld
azerty-klaviertje	azertyklaviertje
staatsliedenbuurt	Staatsliedenbuurt
gedateert	gedateerd
vetellen	vertellen
weltrusten	welterusten
gespuugt	gespuugd
gecasseerdt	gecasseerd
prince	Prince
A4tje	A4'tje
ge-emaild	ge-e-maild
goedgekeurt	goedgekeurd
ingeschakelt	ingeschakeld
bedodt	bedot
uitgebloeit	uitgebloeid
geannuleert	geannuleerd
gèk	gék
6mm	6 mm
gedoodt	gedood
geregelt	geregeld
geïnstalleerdt	geïnstalleerd
9m	9 m
prestatie-afspraken	prestatieafspraken
ate	aten
geïllustreerdt	geïllustreerd
zij-instromer	zijinstromer
geschroeft	geschroefd
Ijse	IJse
duizend-en-een-nacht	Duizend-en-een-nacht
semi-professionele	semiprofessionele
stortlokaties	stortlocaties
íemand	íémand
82km	82 km
geïnterpreteert	geïnterpreteerd
gedaagt	gedaagd
geëvolueert	geëvolueerd
iemamd	iemand
omgedraait	omgedraaid
uitgebroedt	uitgebroed
vice-voorzitters	vicevoorzitters
ontdekd	ontdekt
bestratingwerkzaamheden	bestratingswerkzaamheden
variantie-analyse	variantieanalyse
gesleurt	gesleurd
-west	west
opgestuurt	opgestuurd
semi-akoestische	semiakoestische
sekreten	secreten
Foto`s	Foto's
johnny	Johnny
malle praat	mallepraat
leasies	laesies
milieu-economie	milieueconomie
Rijssel	Rijsel
ingekleurt	ingekleurd
presies	precies
afweet	af weet
7miljard	7 miljard
doorgespeeldt	doorgespeeld
cruisecontrole	cruisecontrol
pouw	pauw
geweesdt	geweest
gedubt	gedubd
gehydrateert	gehydrateerd
sterksmakend	sterk smakend
gewaarborgt	gewaarborgd
veul	veel
aswoensdag	Aswoensdag
gillette	Gillette
thuya's	thuja's
gedegradeert	gedegradeerd
apengapen	apegapen
schotland	Schotland
kamermeerderheid	Kamermeerderheid
afleidingsmanoevre	afleidingsmanoeuvre
jeetjes	jeetje
openbaarvervoer	openbaar vervoer
zogezegt	zogezegd
cruisers	kruisers
IB`er	IB'er
geschikd	geschikt
morse-code	morsecode
stedebouwkundige	stedenbouwkundige
uitgebuid	uitgebuit
gekleedt	gekleed
kreditkaartverwerker	kredietkaartverwerker
kiend	kind
binnengehaalt	binnengehaald
ingeënd	ingeënt
qwertz-toetsenbordjes	qwertztoetsenbordjes
uitgesmeert	uitgesmeerd
vijfsterren	vijf sterren
beerpunt	beerput
nevenlokatiebeleid	nevenlocatiebeleid
gepunten	gepunte
Facebook-groep	Facebookgroep
manouvreerde	manoeuvreerde
uitstekkend	uitstekend
ADHDer	ADHD'er
labyrinthen	labyrinten
menske	mensje
getreurt	getreurd
prakticant	praktikant
Appe`l	Appel
getypd	getypt
aberatie	aberratie
jeetje mina	jeetjemina
spand	spant
klassesolidariteit	klassensolidariteit
opgewekd	opgewekt
coulissenlandschapje	coulisselandschapje
ternouwernood	ternauwernood
vakantie-activiteiten	vakantieactiviteiten
aangestuurt	aangestuurd
milieu-onvriendelijk	milieuonvriendelijk
gelynchd	gelyncht
vergult	verguld
kastesysteem	kastensysteem
gezegdt	gezegd
functieuitrusting	functie-uitrusting
afgescheurdt	afgescheurd
gejuichd	gejuicht
gedagvaart	gedagvaard
aangebrandt	aangebrand
búiten	búíten
weldegelijk	wel degelijk
lidtekenweefsels	littekenweefsels
productieuitval	productie-uitval
gesnippert	gesnipperd
genie-officieren	genieofficieren
pikketanussie	pikketanissie
politie-optreden	politieoptreden
gediscrimineerdt	gediscrimineerd
bronen	bronnen
gewapent	gewapend
gewaait	gewaaid
Ijbergen	IJbergen
scheidrechter	scheidsrechter
haatliefdeverhoudingen	haat-liefdeverhoudingen
top-8	top 8
euro`s	euro's
donkerhouten	donker houten
hippie-achtige	hippieachtige
démarche	demarche
verzed	verzet
bouwlokatie	bouwlocatie
lumineux	lumineus
5km	5 km
afhad	af had
geblowt	geblowd
geoppert	geopperd
koerske	koersje
nogmaal	nogmaals
kledingsstukken	kledingstukken
grabbelpas	Grabbelpas
teminste	tenminste
opgeschudt	opgeschud
Tweede Kamer-leden	Tweede Kamerleden
wolkenloze	wolkeloze
afgestudeert	afgestudeerd
brexit-strategie	brexitstrategie
gepompd	gepompt
gecontinueerdt	gecontinueerd
gewikkelt	gewikkeld
milieu-aantasting	milieuaantasting
ongelovelijk	ongelofelijk
ontplofd	ontploft
verhart	verhard
gewoondt	gewoond
opgetilt	opgetild
gegooidt	gegooid
politie-onderzoek	politieonderzoek
doorgevoert	doorgevoerd
WOII	WO II
examenopgaves	examenopgaven
eeneiïge	eeneiige
gestroomlijnt	gestroomlijnd
megalitische	megalithische
labyrinth	labyrint
schaalniveau's	schaalniveaus
uitgebalanceert	uitgebalanceerd
dooske	doosje
bijgevoegt	bijgevoegd
fleske	flesje
interimregering	interim-regering
semi-ambtenaren	semiambtenaren
analyst	analist
gezondt	gezond
-wellicht	wellicht
gepelt	gepeld
geblaadt	geblaat
miereneukers	mierenneukers
murks	Murks
sociaalpolitieke	sociaal-politieke
zoodoende	zodoende
gefrustreert	gefrustreerd
semi-natuurlijke	seminatuurlijke
gehat	gehad
lente-achtig	lenteachtig
gearbeidt	gearbeid
paardekastanje	paardenkastanje
miereneuker	mierenneuker
Nederlands Antilliaan	Nederlands-Antilliaan
subsidieuitgaven	subsidie-uitgaven
0mm	0 mm
geopenbaart	geopenbaard
ingestuurt	ingestuurd
gegraveert	gegraveerd
gebeterdt	gebeterd
quiz-vraag	quizvraag
praktij	praktijk
gefourageerd	gefoerageerd
gestucd	gestuct
persbureau's	persbureaus
afgezegdt	afgezegd
geboekd	geboekt
Oost-Zeeuws-Vlaanderen	Oost Zeeuws-Vlaanderen
gekopieert	gekopieerd
klassebureau	klassenbureau
incassobureau's	incassobureaus
milieu-onderwerp	milieuonderwerp
topvijf	top vijf
ìs	ís
passiezondag	Passiezondag
Wim2	Wim
gewensd	gewenst
voorgelegt	voorgelegd
gekweekd	gekweekt
gestroomt	gestroomd
milieu-omstandigheden	milieuomstandigheden
geklasseerdt	geklasseerd
collet	kollet
vice-rector	vicerector
geret	gered
60+-ers	60+'ers
85km	85 km
para-militaire	paramilitaire
twitter	Twitter
uitgehaaldt	uitgehaald
Jesus	Jezus
oost-west-as	oost-westas
lovert	lover
gebombardeert	gebombardeerd
afgerekent	afgerekend
doo	door
konstatering	constatering
milieu-overlast	milieuoverlast
Ijzerwake	IJzerwake
2ms	2 ms
rosé's	rosés
gedeelt	gedeeld
geassisteert	geassisteerd
òver	óver
afgebeldt	afgebeld
geintimideerd	geïntimideerd
Tokyo	Tokio
afgevaardigdt	afgevaardigd
gedimdt	gedimd
milieu-onderzoek	milieuonderzoek
milieu-effect	milieueffect
letergreep	lettergreep
losgeschudt	losgeschud
gereserveert	gereserveerd
toegangkelijk	toegankelijk
naijlende	na-ijlende
milieu-effectrapport	milieueffectrapport
aangegroeit	aangegroeid
gesubsidieert	gesubsidieerd
sociaalethisch	sociaal-ethisch
verleedt	verleed
gestaldt	gestald
cd`s	cd's
jane	Jane
milieu-effectrapportage	milieueffectrapportage
mn	m'n
VVD-er	VVD'er
opgevult	opgevuld
viscose-oplossing	viscoseoplossing
inhaalmanouvre	inhaalmanoeuvre
PvdA-ers	PvdA'ers
gebeidt	gebeid
geliked	geliket
bijgesteldt	bijgesteld
gestuurdt	gestuurd
geschoolt	geschoold
diezel	diesel
inbde	in de
aangemoedigdt	aangemoedigd
bioindustrie	bio-industrie
hóe	hóé
ziekte's	ziektes
gesmult	gesmuld
sponsers	sponsors
gewijt	gewijd
megalitisch	megalithisch
WAO-ers	WAO'ers
hat	het
PVDA-ers	PVDA'ers
geordent	geordend
voorzittersschap	voorzitterschap
1minuut	1 minuut
geborgt	geborgd
ambachtschool	ambachtsschool
gereinigt	gereinigd
uitgelooft	uitgeloofd
attachée	attaché
uitgeduidt	uitgeduid
financien	financiën
2kg	2 kg
gefinanciert	gefinancierd
gedefiniëerd	gedefinieerd
gegrilt	gegrild
loco-burgemeesters	locoburgemeesters
hep	heb
gediskwalificeert	gediskwalificeerd
geregistreert	geregistreerd
uitgespaart	uitgespaard
gepoogt	gepoogd
verdampd	verdampt
gelinkd	gelinkt
nachtmerrie-achtige	nachtmerrieachtige
calibratiemethode	kalibratiemethode
teruggedraait	teruggedraaid
gesnipperdt	gesnipperd
gedoneert	gedoneerd
bewolkd	bewolkt
gedoseerdt	gedoseerd
skiërt	skiër
overgehevelt	overgeheveld
gecreëert	gecreëerd
1m³	1 m³
Ijzerman	IJzerman
chateau briand	chateaubriand
milieu-emissies	milieuemissies
vakantie-appartement	vakantieappartement
weggeleidt	weggeleid
kandidaatlidstaten	kandidaat-lidstaten
afgestrafd	afgestraft
gegunt	gegund
anti-autoritair	antiautoritair
woordvoeder	woordvoerder
aangevoerdt	aangevoerd
gesaneerdt	gesaneerd
carriere	carrière
snoeverd	snoever
gewijzigt	gewijzigd
doof-blinde	doofblinde
krimpe	krimpen
Marijuana	Marihuana
gecommitteert	gecommitteerd
apekolonie	apenkolonie
informatie-avond	informatieavond
eigend	eigen
ingebrandt	ingebrand
geënd	geënt
klassestrijd	klassenstrijd
semi-grafische	semigrafische
gemonteert	gemonteerd
deinstalleren	de-installeren
selectiebureau's	selectiebureaus
Bachhus	Bacchus
gewont	gewond
koninginnesoep	koninginnensoep
ingecalculeerdt	ingecalculeerd
rechtevenredig	recht evenredig
dactyl	Dactyl
getriggert	getriggerd
geleverdt	geleverd
voltijdsaanstellingen	voltijdaanstellingen
nageleeft	nageleefd
vermisd	vermist
tableau's	tableaus
GL-ers	GL'ers
heid	hei
geweesd	geweest
therapieituatie	therapiesituatie
Kiparissia	Kyparissia
gecruisd	gecruised
ver-schillen	verschillen
gestilt	gestild
1maart	1 maart
pseudointellectuele	pseudo-intellectuele
Ijzeren	IJzeren
achterwant	achterwand
enqueteren	enquêteren
8km	8 km
aangewendt	aangewend
sms-ten	sms'ten
opgetekent	opgetekend
B+B	B&B
5kg	5 kg
gefascineert	gefascineerd
Nieuw-Kastilië	Nieuw-Castilië
gefinishd	gefinisht
omgekeert	omgekeerd
hybride-aandrijving	hybrideaandrijving
televisieuitzending	televisie-uitzending
dubbelcd-editie	dubbel-cd-editie
adviesbureau's	adviesbureaus
Nicolas Sarcozy	Nicolas Sarkozy
aanvoerdster	aanvoerster
bétablokkers	bètablokkers
gewaarschuwt	gewaarschuwd
semi-bekende	semibekende
Hawaiaanse	Hawaïaanse
geëigendt	geëigend
gekendt	gekend
tweeliter	tweeliter-
qwerty-toetsenbordjes	qwertytoetsenbordjes
vervoerwerkzaamheden	vervoerswerkzaamheden
voortuitgang	vooruitgang
dènken	dénken
geslingert	geslingerd
geschaardt	geschaard
danook	dan ook
voltijdsaanstelling	voltijdaanstelling
aanrijdtijd	aanrijtijd
aikidoexamen	aikido-examen
genoemt	genoemd
doorgebrandt	doorgebrand
gehuilt	gehuild
gekweldt	gekweld
gestrooidt	gestrooid
joppe	Joppe
geplundert	geplunderd
gerenoveert	gerenoveerd
zoniet	zo niet
aangevult	aangevuld
excuustrusen	excuustruzen
gevedt	gevet
semi-logistieke	semilogistieke
geantwoort	geantwoord
achtienjarig	achttienjarig
pseudo-wetenschappers	pseudowetenschappers
uitgebreidt	uitgebreid
diskman	discman
uitgelood	uitgeloot
gedaand	gedaan
semi-autonome	semiautonome
òns	óns
Galápagoseilanden	Galapagoseilanden
Mont-Saint-Michel	Mont Saint-Michel
gestoordt	gestoord
huwlijk	huwelijk
milieu-educatie	milieueducatie
roodbeen	Roodbeen
íets	íéts
3kg	3 kg
gestemdt	gestemd
gestord	gestort
vice-admiraal	viceadmiraal
1m	1 m
milieu-educatief	milieueducatief
gedachtenstreep	gedachtestreep
semi-klassieke	semiklassieke
gebrant	gebrand
welteruste	welterusten
opelkaar	op elkaar
NEN-5740	NEN 5740
gekastijdt	gekastijd
noodopvang-achtige	noodopvangachtige
zweers	Zweers
informatie-overdracht	informatieoverdracht
familieuitje	familie-uitje
moederdag	Moederdag
poepert	poeper
prinsgemaal	prins-gemaal
gezaaidt	gezaaid
parauniversitair	para-universitair
pony`s	pony's
gesnoeit	gesnoeid
gedurft	gedurfd
geschilt	geschild
medegedeelt	medegedeeld
5ml	5 ml
geduidt	geduid
gemoeit	gemoeid
service-georiënteerd	servicegeoriënteerd
gedachtenstreepjes	gedachtestreepjes
gedownloadt	gedownload
gestooft	gestoofd
zij-invoer	zijinvoer
geuid	geuit
onkangs	onlangs
80km	80 km
m₂	m²
voorgeschotelt	voorgeschoteld
machtspelletjes	machtsspelletjes
6mei	6 mei
kilo`s	kilo's
xenos	Xenos
achtien	achttien
fietske	fietsje
gevalideert	gevalideerd
opgebrandt	opgebrand
komputers	computers
geledt	gelet
geëxploiteerdt	geëxploiteerd
vice-president	vicepresident
avondster	Avondster
alover	al over
PVV-er	PVV'er
afgehardt	afgehard
skijacks	ski-jacks
morgenland	Morgenland
omgevormdt	omgevormd
Jesus'	Jezus'
-was	was
consultatiebureau's	consultatiebureaus
8m	8 m
specialismes	specialismen
50+-ers	50+'ers
gespecialiseert	gespecialiseerd
opensource	open source
CO²-heffing	CO₂-heffing
vakantie-adres	vakantieadres
geprocedeert	geprocedeerd
55+-ers	55+'ers
Brommelia	Bromelia
brexit-onderhandelingen	brexitonderhandelingen
verwoort	verwoord
opgedroogt	opgedroogd
ònder	ónder
trillingsniveau's	trillingsniveaus
vrijiating	vrijlating
yakboterthee	jakboterthee
aangevuldt	aangevuld
gecreëerdt	gecreëerd
gediscrimineert	gediscrimineerd
gesteriliseert	gesteriliseerd
bijstanduitkeringen	bijstandsuitkeringen
ingebet	ingebed
afgezondert	afgezonderd
getypeert	getypeerd
heengeleidt	heengeleid
gebrandt	gebrand
gekluistert	gekluisterd
electriciteitsleidingen	elektriciteitsleidingen
wondende	wonende
cilinidervormig	cilindervormig
gedroogt	gedroogd
geïnformeert	geïnformeerd
Ijsselmonde	IJsselmonde
vice-versa	vice versa
uitgedeelt	uitgedeeld
afgevuurt	afgevuurd
gepromoveert	gepromoveerd
Ijstijd	IJstijd
gespaardt	gespaard
friskes	frisjes
vanweg	vanwege
gehandhaafdt	gehandhaafd
geweldt	geweld
electriciteitscentrale	elektriciteitscentrale
rechtsextremistische	rechts-extremistische
voorgesteldt	voorgesteld
mediabureau's	mediabureaus
gebladert	gebladerd
7km	7 km
gedistilleert	gedistilleerd
vogelenzang	Vogelenzang
stillaan	stilaan
afgekeurt	afgekeurd
geselecteerdt	geselecteerd
opgetelt	opgeteld
Bourouillaan	Bourouilllaan
compact-camera	compactcamera
gehaaldt	gehaald
ingekwartiert	ingekwartierd
vice-presidentskandidate	vicepresidentskandidate
geregisseert	geregisseerd
getekendt	getekend
belanghebbendes	belanghebbenden
sponseren	sponsoren
werklokaties	werklocaties
aangewakkert	aangewakkerd
Marshallaan	Marshalllaan
mond-opmondbeademing	mond-op-mondbeademing
ingelevert	ingeleverd
ye	te
geruïneerdt	geruïneerd
hoger-onderwijsinstellingen	hogeronderwijsinstellingen
vuurduin	Vuurduin
bekleet	bekleed
desector	de sector
grafgiftes	grafgiften
noordpoolreizigers	Noordpoolreizigers
gehoordt	gehoord
geviert	gevierd
ingelijft	ingelijfd
gedempd	gedempt
malariaepidemieën	malaria-epidemieën
attaché-koffers	attachékoffers
opgaves	opgaven
semi-ambtelijk	semiambtelijk
gewekd	gewekt
dwarslesie	dwarslaesie
paralellen	parallellen
masaal	massaal
politie-regio	politieregio
opgestuurdt	opgestuurd
ransig	ranzig
lokatiebepaling	locatiebepaling
ransige	ranzige
Pvda'ers	PvdA'ers
qwerty-klavieren	qwertyklavieren
fraxodi	Fraxodi
balcon	balkon
gemankeerdt	gemankeerd
gehuldigt	gehuldigd
zèlfs	zélfs
quizen	quizzen
mama`s	mama's
politie-acties	politieacties
Ijskoud	IJskoud
zaadvragen	zaad vragen
omgebouwt	omgebouwd
belder	Belder
regina	Regina
ruimtevaarttuigen	ruimtevaartuigen
uitgedaagt	uitgedaagd
kiezerscorps	kiezerskorps
getrouwt	getrouwd
westende	Westende
vice-premierschap	vicepremierschap
geblokkeerdt	geblokkeerd
uitgeschakelt	uitgeschakeld
1miljard	1 miljard
ICT-er	ICT'er
geinstalleerd	geïnstalleerd
7m	7 m
claxonerend	claxonnerend
goedrecht	goed recht
would-be-actrice	would-beactrice
uitgeroeidt	uitgeroeid
milieu-argument	milieuargument
aangepasd	aangepast
1kW	1 kW
gehoopd	gehoopt
gedult	geduld
gevonnisd	gevonnist
rechtzaak	rechtszaak
gelevert	geleverd
beslotend	besloten
Bachus	Bacchus
vacuüm verpakt	vacuümverpakt
getolereert	getolereerd
gelimiteert	gelimiteerd
diskanten	discanten
gekarameliseerd	gekaramelliseerd
4km	4 km
gegarandeert	gegarandeerd
opgekuisd	opgekuist
geproduceert	geproduceerd
Ijsvogel	IJsvogel
belastingstrucs	belastingtrucs
gemoldt	gemold
PvdA-er	PvdA'er
Randstadrail	RandstadRail
biesbok	blesbok
meno	memo
niet-bijbelse	niet-Bijbelse
scheffer	Scheffer
getaxeert	getaxeerd
algorithme	algoritme
gestemt	gestemd
gestresd	gestrest
bijgestelt	bijgesteld
thuisvoel	thuis voel
gedagvaardt	gedagvaard
Híer	Híér
opnieuwe	opnieuw
top-15	top 15
driekwartier	drie kwartier
geoxideert	geoxideerd
uitgebeeldt	uitgebeeld
bijiagen	bijlagen
karamelleverzen	karamellenverzen
opgelosd	opgelost
appe`l-	appel-
pitoresk	pittoresk
gestabiliseert	gestabiliseerd
stemmerd	stemmer
ingebreidt	ingebreid
opgelaaidt	opgelaaid
gecombineerdt	gecombineerd
onmiddelijke	onmiddellijke
gemoordt	gemoord
ingestelt	ingesteld
sportaccomodaties	sportaccommodaties
vedische	Vedische
geïnt	geïnd
taxi`s	taxi's
volklied	volkslied
azerty-toetsenbordjes	azertytoetsenbordjes
beveiliginsincident	beveiligingsincident
risico-arm	risicoarm
watercypres	watercipres
semi-bungalows	semibungalows
geblokkeert	geblokkeerd
1ml	1 ml
gezagsvoerder	gezagvoerder
gescheelt	gescheeld
opgelevert	opgeleverd
geconcludeert	geconcludeerd
gecrashd	gecrasht
zelgeknutseld	zelfgeknutseld
gelegdt	gelegd
vos-cursus	voscursus
zzp-er	zzp'er
àndere	ándere
aanmoeten	aan moeten
sociaalrealistisch	sociaal-realistisch
zone's	zones
thema`s	thema's
getildt	getild
5miljoen	5 miljoen
geparkeerdt	geparkeerd
anti-abortus	antiabortus
gemasseert	gemasseerd
azerty-toetsenbord	azertytoetsenbord
megainvesteringen	mega-investeringen
geschorsd	geschorst
Apachedans	apachedans
rijswijk	Rijswijk
s-Hertogenbosch	's-Hertogenbosch
oft	loft
uitgedunt	uitgedund
bovend	boven
semi-openbaar	semiopenbaar
verantwoort	verantwoord
gevoegt	gevoegd
vice-voorzitster	vicevoorzitster
ordend	ordent
getimmert	getimmerd
toegewensd	toegewenst
semi-commerciële	semicommerciële
roestvrijstaal	roestvrij staal
sérieux'	sérieux
milieu-architectuur	milieuarchitectuur
gemixd	gemixt
gewiedt	gewied
facultiet	faculteit
Ijlst	IJlst
gemisd	gemist
informatie-aanbod	informatieaanbod
Hoogvlakte van Oud-Kastilië	Hoogvlakte van Oud-Castilië
bestandsdelen	bestanddelen
molenaarsgraaf	Molenaarsgraaf
tweecylinder	tweecilinder
zenderontvangers	zender-ontvangers
geroeit	geroeid
getransformeert	getransformeerd
doktor	dokter
ziektenkostenregelingen	ziektekostenregelingen
achttiend	achttiende
babyzitter	babysitter
Ijslands	IJslands
ruzie-achtige	ruzieachtige
annemieke	Annemieke
leverd	levert
yak	jak
afgerondt	afgerond
faeces	feces
dj`s	dj's
uitgebrandt	uitgebrand
genagelt	genageld
gemendt	gemend
gelobt	gelobd
centrale-bankpresidenten	centralebankpresidenten
milieuinformatie	milieu-informatie
cadeau's	cadeaus
compactdiscs	compact discs
Ijssel	IJssel
gecertificeert	gecertificeerd
sovjetstaat	Sovjetstaat
éé'n	één
onderzoekuitgaven	onderzoeksuitgaven
gerestaureert	gerestaureerd
toegevoegdt	toegevoegd
cliche	cliché
mijoen	miljoen
gemerkdt	gemerkt
wíe	wíé
-wel	wel
ingevoert	ingevoerd
mac	Mac
gevestigdt	gevestigd
deser	dezer
waalwijk	Waalwijk
kledingsstuk	kledingstuk
renaisanceschilders	renaissanceschilders
kompleet	compleet
gecontacteert	gecontacteerd
belastingsaftrekken	belastings aftrekken
informatie-analyse	informatieanalyse
apekolonies	apenkolonies
gevoldt	gevold
verranderingen	veranderingen
ingetaped	ingetapet
geëxpireerdt	geëxpireerd
zescylinder	zescilinder
hamertje tik	hamertje-tik
omgevormt	omgevormd
tussend	tussen
bijdehandte	bijdehante
berceau's	berceaus
weggevoert	weggevoerd
Levencyclus	Levenscyclus
semi-automatische	semiautomatische
gebreidt	gebreid
top-10	top 10
uitbesteet	uitbesteed
dioxine-achtige	dioxineachtige
bestrafd	bestraft
verled	verlet
uitgekient	uitgekiend
afgespeelt	afgespeeld
nobelprijswinnaar	Nobelprijswinnaar
verschafd	verschaft
vervreemt	vervreemd
geactiveert	geactiveerd
geplanten	geplante
licenti	licentie
semi-aquatische	semiaquatische
milieu-ambtenaren	milieuambtenaren
reve	Reve
gevisd	gevist
zodadelijk	zo dadelijk
naarbinnen	naar binnen
insekticiden	insecticiden
begroed	begroet
gejaagt	gejaagd
piña	pina
GDV-lokatie	GDV-locatie
geruimt	geruimd
geconverteert	geconverteerd
nonactief	non-actief
vij	bij
mijard	miljard
gecensureerdt	gecensureerd
veiligheidlekken	veiligheidslekken
uitgespreidt	uitgespreid
hofland	Hofland
afgestemt	afgestemd
schreur	Schreur
maneuvres	manoeuvres
dodehoek	dode hoek
zenger	zanger
geverfdt	geverfd
teleurgestelt	teleurgesteld
anti-autoritaire	antiautoritaire
gecompliceert	gecompliceerd
gemeent	gemeend
ontfangen	ontvangen
piket-auto	piketauto
gepleurdt	gepleurd
jodenjacht	Jodenjacht
ruimtevaarttuig	ruimtevaartuig
milieu-atlas	milieuatlas
tau-eiwit	taueiwit
pétanque	petanque
Elen	Ellen
androidtoestel	Androidtoestel
maandelijke	maandelijkse
bosfeeen	bosfeeën
politie-opleidingen	politieopleidingen
Bijoux	Bijous
spellingswijziging	spellingwijziging
analyse-apparatuur	analyseapparatuur
gewilt	gewild
mede-ondernemer	medeondernemer
geraadpleegt	geraadpleegd
passagierschip	passagiersschip
opgelegt	opgelegd
gevormt	gevormd
woningbouwlokaties	woningbouwlocaties
niét	níét
ingesteldt	ingesteld
gestard	gestart
geduldt	geduld
winlokatie	winlocatie
uitgebreit	uitgebreid
gelandt	geland
lipitor	Lipitor
MBO-Raad	MBO Raad
sangen	Sangen
gedeporteert	gedeporteerd
merlijn	marlijn
gekudt	gekut
kiloos	kilo's
schilderswijk	Schilderswijk
ten tweede male	ten tweeden male
geïsoleerdt	geïsoleerd
waardenlijsten	waardelijsten
1miljoen	1 miljoen
gehadt	gehad
informatieuitwisseling	informatie-uitwisseling
overgevloeidt	overgevloeid
sportbh's	sport-bh's
omgedoopd	omgedoopt
uitgewisselt	uitgewisseld
bijvoorbeeldde	bijvoorbeeld de
ooggetuigeverslag	ooggetuigenverslag
vice-fractievoorzitter	vicefractievoorzitter
Hergé's	Hergés
amer	Amer
geredeneert	geredeneerd
gelegt	gelegd
milieu-audit	milieuaudit
NEN2575	NEN 2575
gelabelt	gelabeld
geëisd	geëist
gewaardeerdt	gewaardeerd
aangelevert	aangeleverd
gezondsheidszorg	gezondheidszorg
lensen	lenzen
hi hi	hihi
off-topic	offtopic
verspreit	verspreid
secretaressenoverleg	secretaresseoverleg
belastingsgelden	belastinggelden
's Gravenvoeren	's-Gravenvoeren
hanzestad	Hanzestad
uberhaupt	überhaupt
verzonde	verzonden
viercylinder	viercilinder
onderstal	Onderstal
ingewikkelt	ingewikkeld
1mg	1 mg
orleans	Orleans
CDA-er	CDA'er
gesleepd	gesleept
tweevijfde	twee vijfde
96kHz	96 kHz
waarempel	warempel
pannekoekjes	pannenkoekjes
kreatieve	creatieve
88km	88 km
hindoe-nationalisten	hindoenationalisten
geruimdt	geruimd
gevloeit	gevloeid
gekwetsd	gekwetst
gespeculeert	gespeculeerd
gestrafd	gestraft
geïllustreert	geïllustreerd
qwertz-klavier	qwertzklavier
reedst	reeds
vice-decaan	vicedecaan
Jan's	Jans
aangevraagt	aangevraagd
geroostert	geroosterd
getraint	getraind
pseudo-wetenschap	pseudowetenschap
afgemeldt	afgemeld
Emancipatiekommissie	Emancipatiecommissie
gekarameliseerde	gekaramelliseerde
gekent	gekend
zo`n	zo'n
bijgevult	bijgevuld
6cm	6 cm
geheelt	geheeld
bedrijvenlokaties	bedrijvenlocaties
America's	Amerika's
afgewisselt	afgewisseld
geveer	gever
geaccomodeerd	geaccommodeerd
gewurgt	gewurgd
qwerty-klaviertjes	qwertyklaviertjes
utrecht	Utrecht
genoodzaakd	genoodzaakt
nazi-politicus	nazipoliticus
gedigitaliseert	gedigitaliseerd
coming out	coming-out
Asgard	Asgaard
overgewaait	overgewaaid
software-oplossing	softwareoplossing
decentralisatieuitkering	decentralisatie-uitkering
opgedient	opgediend
bétablokker	bètablokker
milieu-actieprogramma	milieuactieprogramma
gereageerdt	gereageerd
gepropageert	gepropageerd
crêche	crèche
milieu-actieplannen	milieuactieplannen
négligé	negligé
gewinkelt	gewinkeld
-zou	zou
gekeert	gekeerd
ongeloofelijk	ongelooflijk
stembureau's	stembureaus
gehart	gehard
ingestudeert	ingestudeerd
bereikd	bereikt
geformeert	geformeerd
ruimbemeten	ruim bemeten
hoofdoekjes	hoofddoekjes
sponser	sponsor
afgevraagt	afgevraagd
milieuinnovaties	milieu-innovaties
z`n	z'n
goedenmiddag	goedemiddag
glansend	glanzend
uitgezwaait	uitgezwaaid
geknutselt	geknutseld
voorbijgestreeft	voorbijgestreefd
semi-gesloten	semigesloten
gekoestert	gekoesterd
opdrach	opdracht
cylindrische	cilindrische
verbindingstukjes	verbindingsstukjes
elohim	Elohim
gespoelt	gespoeld
blindegeleidehond	blindengeleidehond
ingebouwdt	ingebouwd
aangedurft	aangedurfd
internetcafé's	internetcafés
-wanneer	wanneer
omgerekent	omgerekend
lenteuitjes	lente-uitjes
soeten	Soeten
wekfles	weckfles
yaks	jaks
u-vormig	U-vormig
Rembrand	Rembrandt
video`s	video's
ingedient	ingediend
milieu-opleidingen	milieuopleidingen
sergant-majoor	sergeant-majoor
getroosd	getroost
uitkunt	uit kunt
Churchillaan	Churchilllaan
1kg	1 kg
georganiseert	georganiseerd
gewildt	gewild
opgebelt	opgebeld
gereist	gereisd
pasport	paspoort
weggestuurt	weggestuurd
beteert	beteerd
allem	alle
jodenjongen	Jodenjongen
rechtoe	rechttoe
pole-positie	polepositie
opgestapelt	opgestapeld
laissez-faire	laisser-faire
software-oplossingen	softwareoplossingen
gerecyclet	gerecycled
middenrijk	Middenrijk
gesuggereert	gesuggereerd
kalashnikovs	kalasjnikovs
handlen	handelen
overgehaalt	overgehaald
extrapyramidaal	extrapiramidaal
gefronsd	gefronst
teleurgesteldt	teleurgesteld
gefaalt	gefaald
gebloeit	gebloeid
milieu-aangelegenheden	milieuaangelegenheden
rhinoplastiek	rinoplastiek
beperkd	beperkt
gesloopd	gesloopt
voerzicht	overzicht
plugin	plug-in
's Gravenwezel	's-Gravenwezel
Rubensvrouw	rubensvrouw
aangemeldt	aangemeld
verzorgingstaat	verzorgingsstaat
Ijzelenberg	IJzelenberg
gezaagt	gezaagd
Ijdele	IJdele
thuisvoelt	thuis voelt
ùw	úw
M`n	M'n
piket-adres	piketadres
gewerkd	gewerkt
kort-gedingrechter	kortgedingrechter
gestrant	gestrand
geragdt	geragd
A5-jes	A5'jes
afgedraait	afgedraaid
gehuwt	gehuwd
friesland	Friesland
gemerkd	gemerkt
uitgelegdt	uitgelegd
Ijshockey	IJshockey
gerecruteerde	gerekruteerde
ADHD-er	ADHD'er
geskiet	geskied
halucineert	hallucineert
geled	gelet
stiltecoupe	stiltecoupé
sociaal-realisme	sociaalrealisme
milieu-argumenten	milieuargumenten
twee-aderig	tweeaderig
semi-contact	semicontact
getwittert	getwitterd
gedoot	gedood
gemetselt	gemetseld
uitkon	uit kon
aangemoedigt	aangemoedigd
Transactieuitgaven	Transactie-uitgaven
gezeilt	gezeild
bijgewerkd	bijgewerkt
décolleté	decolleté
vééél	véél
goudse	Goudse
getornt	getornd
toeroperators	touroperators
skijassen	ski-jassen
ingezoomt	ingezoomd
enquètes	enquêtes
enterprise-architectuur	enterprisearchitectuur
cylindervormige	cilindervormige
ana	aan
besmed	besmet
avantgardistische	avant-gardistische
meegedeelt	meegedeeld
schoolboordkrijt	schoolbordkrijt
accomoderen	accommoderen
danske	dansje
PVDA-er	PVDA'er
hanneman	Hanneman
ù	ú
gesponsort	gesponsord
bijgevoedt	bijgevoed
eggetanden	eggentanden
ingangdatum	ingangsdatum
ellend	ellende
passage's	passages
sms-en	sms'en
EEG-Verdrag	EEG-verdrag
-wederom	wederom
zeeschilpadden	zeeschildpadden
tekomen	te komen
komputer	computer
aangepakd	aangepakt
claxonerende	claxonnerende
ChristenUnie-leden	ChristenUnieleden
attaché-koffertje	attachékoffertje
gewelt	geweld
linkergrafiek	linker grafiek
wilde Westen	Wilde Westen
gekromdt	gekromd
Facebook-pagina	Facebookpagina
vrouwzijn	vrouw-zijn
geconfigureert	geconfigureerd
pole-position	poleposition
vinex-wijken	Vinex-wijken
compact camera	compactcamera
gewikkeldt	gewikkeld
toegepasd	toegepast
cateringszaken	cateringzaken
kommissaris	commissaris
vooraal	vooral
ingeluist	ingeluisd
belgenmop	Belgenmop
afgelegdt	afgelegd
gedaalt	gedaald
lievend	levend
semi-gestructureerde	semigestructureerde
overheidsniveau's	overheidsniveaus
warmtekrachtcentrale	warmte-krachtcentrale
gebloedt	gebloed
kamermeerderheden	Kamermeerderheden
opgevoert	opgevoerd
regio`s	regio's
software-ontwikkelaars	softwareontwikkelaars
yakboter	jakboter
zorgdroegen	zorg droegen
gestelt	gesteld
mit	met
noord-westelijke	noordwestelijke
6maanden	6 maanden
Ijzendijke	IJzendijke
óok	óók
gemanipuleert	gemanipuleerd
NEN5740	NEN 5740
accomodatie	accommodatie
achtienjarige	achttienjarige
geventileert	geventileerd
meegesleurt	meegesleurd
gemonitort	gemonitord
abberrant	aberrant
dvd`s	dvd's
opgevoerdt	opgevoerd
afgehad	af gehad
gerolt	gerold
exploitatieuitgaven	exploitatie-uitgaven
politie-onderdelen	politieonderdelen
whatsApp	WhatsApp
bedankd	bedankt
caissiere	caissière
gespreidt	gespreid
UML-klassediagrammen	UML-klassendiagrammen
noordpoolreis	Noordpoolreis
pdfs	pdf's
55+ers	55+'ers
gelukd	gelukt
vandeze	van deze
gegrondt	gegrond
manoevres	manoeuvres
geboudt	gebout
weerszijde	weerszijden
electriciteitsprijs	elektriciteitsprijs
kaptein	kapitein
logement-houders	logementhouders
opgegroeidt	opgegroeid
aangezegt	aangezegd
jaarstermijn	jaartermijn
4uur	4 uur
geofferdt	geofferd
plaatskes	plaatsjes
lichtgolvende	licht golvende
rummikub	Rummikub
Panama-stad	Panama-Stad
Nobelprijs-winnaar	Nobelprijswinnaar
acte de presence	acte de présence
toegedient	toegediend
broodje-aapverhalen	broodjeaapverhalen
tv-programma`s	tv-programma's
oorsponkelijk	oorspronkelijk
tentoongestelt	tentoongesteld
euri	euro
gefotografeerdt	gefotografeerd
opgehoogt	opgehoogd
wes	wens
bijstanduitkering	bijstandsuitkering
ventillatie	ventilatie
geëxperimenteert	geëxperimenteerd
gespeldt	gespeld
hetzelf	het zelf
allroundschaatsert	allroundschaatser
elekra	elektra
stadskanaal	Stadskanaal
bijna-dood-ervaringen	bijna-doodervaringen
interimdividend	interim-dividend
beschud	beschut
vandien	van dien
waadoor	waardoor
caravanserai	karavanserai
masculine	masculien
opgebouwt	opgebouwd
bors	Bors
inkoppert	inkopper
geëert	geëerd
Ijsselmuiden	IJsselmuiden
lokatiegebonden	locatiegebonden
D66-ers	D66'ers
bepland	beplant
zóó	zó
gehuwdt	gehuwd
ingeademt	ingeademd
balladesdichter	balladedichter
geformeerdt	geformeerd
gezed	gezet
omgeleidt	omgeleid
gearresteert	gearresteerd
onderzoeksbureau's	onderzoeksbureaus
dond	vond
pdf-je	pdf'je
ransigste	ranzigste
samengestelt	samengesteld
genie-officier	genieofficier
samengevoegt	samengevoegd
7maart	7 maart
vastenland	vasteland
gebaseert	gebaseerd
geconstateert	geconstateerd
nòg	nóg
recruten	rekruten
poetische	poëtische
moéten	móéten
verrasd	verrast
gewortelt	geworteld
politie-activiteiten	politieactiviteiten
geschrobt	geschrobd
semi-actief	semiactief
H²O	H₂O
bezochd	bezocht
cher	Cher
overgelevert	overgeleverd
bouwlokaties	bouwlocaties
landschapformaat	landschapsformaat
file's	files
programma`s	programma's
omgegooit	omgegooid
gepatenteert	gepatenteerd
geledend	geleden
tricht	Tricht
concièrge	conciërge
19eeeuw	19e eeuw
gebezigt	gebezigd
wagenberg	Wagenberg
gedeponeert	gedeponeerd
gemengt	gemengd
boschage	bosschage
leeggerooft	leeggeroofd
gestansd	gestanst
arbeidsbureau's	arbeidsbureaus
doorkruisd	doorkruist
milieuinvesteringen	milieu-investeringen
rehabilitatie-activiteiten	rehabilitatieactiviteiten
o-benen	O-benen
karater	karakter
quotient	quotiënt
wapenveld	Wapenveld
toegevoegt	toegevoegd
glooiiende	glooiende
moslem	moslim
top-2	top 2
gecommuniceert	gecommuniceerd
holebijongeren	holebi-jongeren
gedirigeert	gedirigeerd
geïntegreert	geïntegreerd
gearriveert	gearriveerd
gevormdt	gevormd
maseurs	masseurs
risico`s	risico's
vice-presidenten	vicepresidenten
semi-finale	semifinale
documentaire-achtige	documentaireachtige
uitgemondt	uitgemond
gepubliceert	gepubliceerd
vice-rectoren	vicerectoren
brexit-onderhandeling	brexitonderhandeling
ingestord	ingestort
bankverzekeraar	bank-verzekeraar
bestaanrecht	bestaansrecht
gepasseert	gepasseerd
informatie-afspraken	informatieafspraken
gesoldeert	gesoldeerd
katastrofale	catastrofale
gescant	gescand
doorde	door de
Kastilië	Castilië
enqueterecht	enquêterecht
pagina`s	pagina's
top-200	top 200
genadert	genaderd
lage-lonenlanden	lagelonenlanden
qwertz-klaviertje	qwertzklaviertje
bebosd	bebost
15jarige	15-jarige
compjuter	computer
d66-fractie	D66-fractie
geïnteresseerdt	geïnteresseerd
studentenkorpsen	studentencorpsen
silvester	Silvester
Ij	IJ
afgestelt	afgesteld
zeeschilpad	zeeschildpad
Curacaose	Curaçaose
genoteert	genoteerd
semi-klassieker	semiklassieker
gekand	gekant
2m	2 m
gement	gemend
croque madame	croque-madame
Capucijnen	Kapucijnen
skijackje	ski-jackje
steenbokskeerkring	Steenbokskeerkring
gestolt	gestold
kawa	Kawa
carière	carrière
functieuitoefening	functie-uitoefening
baardde	baarde
verderweg	verder weg
geoordeeldt	geoordeeld
glazende	glanzende
opgesomt	opgesomd
geplempdt	geplempt
groend	groen
moskee-organisaties	moskeeorganisaties
geschad	geschat
PVV-ers	PVV'ers
overdijk	Overdijk
schilpadden	schildpadden
opgeëisd	opgeëist
accesoires	accessoires
ingezaait	ingezaaid
afgekoelt	afgekoeld
betablokker	bètablokker
geparkeert	geparkeerd
lange-afstandsverbindingen	langeafstandsverbindingen
spierpeesovergang	spier-peesovergang
gestempelt	gestempeld
bèta-opleidingen	bètaopleidingen
gekleurt	gekleurd
kruiske	kruisje
vijfen	vijven
kerver	Kerver
Ijzersterk	IJzersterk
verkloodt	verkloot
gebezigdt	gebezigd
sovjetmacht	Sovjetmacht
uitgekleedt	uitgekleed
geboert	geboerd
minder-draagkrachtige	minderdraagkrachtige
prijze	prijzen
geïmpliceerdt	geïmpliceerd
afgetekent	afgetekend
Soundcloud	SoundCloud
persoonsgebondenbudget	persoonsgebonden budget
besefd	beseft
Bureau's	Bureaus
wekflesjes	weckflesjes
ingewilligt	ingewilligd
polstokspringen	polsstokspringen
twee-assig	tweeassig
politie-apparaat	politieapparaat
paratbc	para-tbc
rechtsextremistisch	rechts-extremistisch
tegend	tegen
dieperliggend	dieper liggend
software-ontwikkeling	softwareontwikkeling
minijurk	mini-jurk
favorite	favoriete
aangepland	aangeplant
geoorlooft	geoorloofd
opgevolgt	opgevolgd
blootgestelt	blootgesteld
onthooft	onthoofd
homo`s	homo's
qwertz-toetsenborden	qwertztoetsenborden
personenauto`s	personenauto's
boschages	bosschages
nagelriempjess	nagelriempjes
ajb	ajb.
x-benen	X-benen
gecompliceerdt	gecompliceerd
qwerty-toetsenbordje	qwertytoetsenbordje
dwarslesies	dwarslaesies
geblogt	geblogd
b-kantje	B-kantje
openTaal	OpenTaal
azerty-toetsenborden	azertytoetsenborden
manoevreerruimte	manoeuvreerruimte
opgespeldt	opgespeld
sint-bernardhondje	sint-bernardshondje
foto`s	foto's
verdiepd	verdiept
zenderontvanger	zender-ontvanger
azimuth	azimut
Verbauwen	Verbouwen
gekneust	gekneusd
toetsteen	toetssteen
geïntroduceerdt	geïntroduceerd
Groot-Britannië	Groot-Brittannië
geregeldt	geregeld
gereet	gereed
Ijslander	IJslander
opgeknapd	opgeknapt
aangemelt	aangemeld
4kg	4 kg
voorzover	voor zover
geraakd	geraakt
gewiidt	gewiid
geschaadt	geschaad
eeneiïg	eeneiig
collage-achtige	collageachtige
geneesmiddelenwet	Geneesmiddelenwet
decentralisatieuitkeringen	decentralisatie-uitkeringen
-westerse	westerse
geprijst	geprijsd
gesmeet	gesmeed
leerwerktraject	leer-werktraject
sperciebonen	sperziebonen
veken	velen
volzit	vol zit
René's	Renés
Bordeaux's	Bordeauxs
65+ers	65+'ers
gehuildt	gehuild
geopereert	geopereerd
Kastiliaans Scheidingsgebergte	Castiliaans Scheidingsgebergte
gemengdt	gemengd
pole-positions	polepositions
backups	back-ups
rogge-aren	roggearen
Ijpelaar	IJpelaar
vinex-locatie	Vinex-locatie
geregistreerdt	geregistreerd
gepakd	gepakt
begond	begon
gespecialiseerdt	gespecialiseerd
welles-nietes-spelletje	welles-nietesspelletje
electriciteit	elektriciteit
Guatemala-stad	Guatemala-Stad
semi-documentaire	semidocumentaire
milieu-aansprakelijkheid	milieuaansprakelijkheid
4-cylinder	4-cilinder
mond-op-mond-beademing	mond-op-mondbeademing
òf	óf
sekte-achtige	sekteachtige
décor	decor
vam	van
politie-organisaties	politieorganisaties
politie-academie	politieacademie
genante	gênante
jongentje	jongetje
5cm	5 cm
Gnuplot	gnuplot
aangelandt	aangeland
comit	comité
geteldt	geteld
vastgestelt	vastgesteld
geproduceerdt	geproduceerd
herz	hertz
NEN3610	NEN 3610
geïnvesteert	geïnvesteerd
doorgestuurt	doorgestuurd
gescrubt	gescrubd
top-100	top 100
djs	dj's
geprepareert	geprepareerd
semi-dichte	semidichte
CU-ers	CU'ers
hanne	Hanne
gemeldt	gemeld
gegrifd	gegrift
weggevaagt	weggevaagd
pseudo-wetenschappelijke	pseudowetenschappelijke
aangekaard	aangekaart
noordpoolreizen	Noordpoolreizen
schutgoot	schudgoot
volkslatijn	Volkslatijn
ingespeelt	ingespeeld
verschansd	verschanst
anti-abortusbesluit	antiabortusbesluit
Jesusgebed	Jezusgebed
voorgewendt	voorgewend
àltijd	áltijd
27jarige	27-jarige
SP-er	SP'er
8mm	8 mm
afgesteldt	afgesteld
afgezaagt	afgezaagd
au-sérieux	au sérieux
gecontracteert	gecontracteerd
gespelt	gespeld
milieu-effectenrapport	milieueffectenrapport
noord-oostelijke	noordoostelijke
gedroogdt	gedroogd
kort-gedingprocedure	kortgedingprocedure
volkerenbond	Volkerenbond
semi-autobiografisch	semiautobiografisch
gezont	gezond
zò	zó
beslisd	beslist
klassefoto	klassenfoto
ade	de
gemaakdt	gemaakt
allert	alert
a-capella	a capella
noire	noir
opgevoedt	opgevoed
gemiddeldt	gemiddeld
voorelkaar	voor elkaar
bacovenwinkel	bacovewinkel
dàt	dát
rechtsextremist	rechts-extremist
komfort	comfort
beugelbh's	beugel-bh's
koningsdagen	Koningsdagen
verluit	verluid
A5jes	A5'jes
Ijverig	IJverig
milieu-econoom	milieueconoom
bevad	bevat
euthenasie	euthanasie
reclamebureau's	reclamebureaus
gereformeert	gereformeerd
uizetten	uitzetten
geheimagent	geheim agent
gestudeert	gestudeerd
geboordt	geboord
getempert	getemperd
grensen	grenzen
drok	druk
kalfzwezeriken	kalfszwezeriken
geramt	geramd
vice-burgemeester	viceburgemeester
nagevraagt	nagevraagd
zenith	zenit
liëerde	lieerde
gespeelt	gespeeld
gejad	gejat
aangekleedt	aangekleed
iPhone-gebruikers	iPhonegebruikers
A5-je	A5'je
gedemonstreert	gedemonstreerd
ingeboed	ingeboet
nazi-achtige	naziachtige
real-time	realtime
finnen	Finnen
hotelrestaurant	hotel-restaurant
sleeds	sleets
stacato	staccato
hept	helpt
kiezerd	kiezer
-welke	welke
schraven	Schraven
klassebehoud	klassenbehoud
gecoördineert	gecoördineerd
gevaccineert	gevaccineerd
genomineert	genomineerd
uitgehaalt	uitgehaald
gesleutelt	gesleuteld
gestopd	gestopt
2ml	2 ml
cassières	caissières
Ijslanders	IJslanders
geïnstalleert	geïnstalleerd
5miljard	5 miljard
aangevraagdt	aangevraagd
EEG-Verordening	EEG-verordening
gedachtenwendingen	gedachtewendingen
vakantielokatie	vakantielocatie
milieu-eisen	milieueisen
ontwikkelingsamenwerking	ontwikkelingssamenwerking
boutst	boudst
uitgekamt	uitgekamd
opgeled	opgelet
afgeschermt	afgeschermd
geopenbaardt	geopenbaard
bolman	Bolman
bestande	bestaande
gezedt	gezet
borstpieren	borstspieren
m`n	m'n
graspop	Graspop
zèlf	zélf
weggespoelt	weggespoeld
gedachtenstreepje	gedachtestreepje
cymbalen	cimbalen
overheersd	overheerst
geziende	geziene
maisonettes	maisonnettes
geregeerdt	geregeerd
gedraait	gedraaid
gestremt	gestremd
geëerbiedigdt	geëerbiedigd
gereageert	gereageerd
getolereerdt	getolereerd
Kastiliaans	Castiliaans
croque monsieurs	croque-monsieurs
studieuitval	studie-uitval
heila	Heila
uitgekeert	uitgekeerd
geenzins	geenszins
Atjeese	Atjese
jans	Jans
politieen	politie en
pdf-format	pdf-formaat
ingevult	ingevuld
geremt	geremd
subsidie-aanvraag	subsidieaanvraag
negentiend	negentiende
langparkeren	lang parkeren
dubbel-cdedities	dubbel-cd-edities
cateringszaak	cateringzaak
gesparen	besparen
beveiliginsincidenten	beveiligingsincidenten
dubbelcd	dubbel-cd
gekunt	gekund
geëxecuteert	geëxecuteerd
practikant	praktikant
schilp	Schilp
ontwikkelingslokaties	ontwikkelingslocaties
ski-jacke	ski-jack
gepolijsd	gepolijst
top-500	top 500
sint-bernardhond	sint-bernardshond
cadeaux	cadeaus
aangekondigt	aangekondigd
gedroomt	gedroomd
romeins	Romeins
politie-functionarissen	politiefunctionarissen
spercieboontje	sperzieboontje
maisje	meisje
gestaaft	gestaafd
milieu-element	milieuelement
geflankeert	geflankeerd
claxoneren	claxonneren
paras	para's
Colokatie	Colocatie
para-medici	paramedici
waaròm	waaróm
recherchebureau's	recherchebureaus
ingedeelt	ingedeeld
Vinexwijken	Vinex-wijken
Indiers	Indiërs
gebabbelt	gebabbeld
gedrukd	gedrukt
geduwt	geduwd
goe	goed
najaars	najaars-
ingegooit	ingegooid
geborgdt	geborgd
afgewendt	afgewend
hèbben	hébben
ingelegt	ingelegd
A4tjes	A4'tjes
electriciteitscentrales	elektriciteitscentrales
gevelt	geveld
vice-voorzitter	vicevoorzitter
begripvorming	begripsvorming
gehaad	gehaat
helem	hele
èchte	échte
sportaccomodatie	sportaccommodatie
afgewerkd	afgewerkt
2cm	2 cm
díe	díé
dènk	dénk
politie-officieren	politieofficieren
zorgdroeg	zorg droeg
gegarandeerdt	gegarandeerd
aangelegt	aangelegd
gepleid	gepleit
drietrapsrakket	drietrapsraket
effend	effen
gemenerikken	gemeneriken
televisie-activiteiten	televisieactiviteiten
gevordert	gevorderd
gepositioneert	gepositioneerd
oud-ooms	oudooms
gehyped	gehypet
neergelegt	neergelegd
politie-ambtenaren	politieambtenaren
getovert	getoverd
CDA-ers	CDA'ers
goedertierend	goedertieren
transitie-aanpak	transitieaanpak
europarlementariërs	Europarlementariërs
wiite	witte
subway	Subway
getind	getint
versterkd	versterkt
gescoort	gescoord
mel	Mel
milie	milieu
Hitler's	Hitlers
bediendenkamers	bediendekamers
-zowel	zowel
eetcafé's	eetcafés
moslim-fundamentalistische	moslimfundamentalistische
afgeleit	afgeleid
androidtoestellen	Androidtoestellen
semi-akoestisch	semiakoestisch
autoinbraken	auto-inbraken
informatie-asymmetrie	informatieasymmetrie
vermoet	vermoed
coòrdinator	coördinator
extreem-nationalistisch	extreem nationalistisch
aangeklaagdt	aangeklaagd
toegestuurt	toegestuurd
geschuurt	geschuurd
gespreit	gespreid
geknalt	geknald
Ijsberen	IJsberen
gascylinder	gascilinder
ångströms	ångström
zombie-achtige	zombieachtige
opname's	opnames
geobsedeert	geobsedeerd
welicht	wellicht
warmte-kracht	warmtekracht
afscheidstoernee	afscheidstournee
rechtsomkeerd	rechtsomkeert
A-lokatie	A-locatie
binnend	binnen
aangevoert	aangevoerd
uitstromert	uitstromer
wekking	werking
prularia	prullaria
strafrechterlijk	strafrechtelijk
geprobeerdt	geprobeerd
genummert	genummerd
dichtsbijzijnde	dichtstbijzijnde
geroemt	geroemd
zijde-achtig	zijdeachtig
beboedt	beboet
hirs	Hirs
geplooit	geplooid
startlokatie	startlocatie
versufd	versuft
getransporteert	getransporteerd
megainvestering	mega-investering
dubbeld	dubbel
goedertierende	goedertierene
politie-bureau	politiebureau
uitgeleeft	uitgeleefd
overgelegt	overgelegd
geteelt	geteeld
asbroek	Asbroek
begripvormingen	begripsvormingen
leerlingverpleegkundigen	leerling-verpleegkundigen
koninggin	koningin
dartspel	dartsspel
Fallopii	fallopii
anti-rookbeleid	antirookbeleid
gehersenspoelt	gehersenspoeld
gestreepd	gestreept
pseudo-wetenschappelijk	pseudowetenschappelijk
zegend	zegent
URLs	URL's
semi-overheden	semioverheden
geschreeuwt	geschreeuwd
-wegens	wegens
Jezuïten	Jezuïeten
software-ontwikkelingen	softwareontwikkelingen
gewondt	gewond
milieu-organisatie	milieuorganisatie
algorithmen	algoritmen
gespaart	gespaard
semi-empirische	semiempirische
skijasjes	ski-jasjes
marijuana	marihuana
plassert	plasser
Ijkema	IJkema
Ijs	IJs
neestemmer	nee-stemmer
gemanouvreerd	gemanoeuvreerd
dichtgegroeidt	dichtgegroeid
excusus	excuses
così	Così
Uwes	Uwe
gehuurt	gehuurd
matze	matse
stevend	stevent
friestalige	Friestalige
SP-kamerleden	SP-Kamerleden
Hawaiaans	Hawaïaans
vergoet	vergoed
servietten	serviettes
tweede-kansonderwijs	tweedekansonderwijs
anderssoortige	andersoortige
locale	lokale
ingevordert	ingevorderd
letstel	letsel
afwil	af wil
gepersonaliseert	gepersonaliseerd
gefeliciteert	gefeliciteerd
voltijdsfunctie	voltijdfunctie
iso-lijnen	isolijnen
aërodynamica	aerodynamica
dialyse-apparaat	dialyseapparaat
buitenaarde	buitenaardse
semi-kwantitatief	semikwantitatief
jurrie	Jurrie
opgerolt	opgerold
semi-permanente	semipermanente
algorithmes	algoritmes
no-fly-zone	no-flyzone
getrimt	getrimd
ex-aequo	ex aequo
's Gravenbrakel	's-Gravenbrakel
0cm	0 cm
afgebrant	afgebrand
toegejuichd	toegejuicht
cyclosporine	ciclosporine
dropouts	drop-outs
skijas	ski-jas
politiebureau's	politiebureaus
milieu-effecten	milieueffecten
geschordt	geschort
oegen	ogen
politie-onderzoeken	politieonderzoeken
gestoomt	gestoomd
tau-eiwitten	taueiwitten
vrijescholen	vrije scholen
démarrage	demarrage
milieu-onderwerpen	milieuonderwerpen
ransiger	ranziger
geweidt	geweid
halucineer	hallucineer
gehoedt	gehoed
gesmeert	gesmeerd
uitgefreesdt	uitgefreesd
ChristenUnie-lid	ChristenUnielid
dubbelcd's	dubbel-cd's
bijnadoodervaring	bijna-doodervaring
collega`s	collega's
sint-bernardhonden	sint-bernardshonden
beijing	Beijing
haarlem	Haarlem
uitgelijnt	uitgelijnd
gedefinieert	gedefinieerd
lokatieniveau	locatieniveau
gestreeft	gestreefd
schie	Schie
justitieelmedisch	justitieel-medisch
gelijmt	gelijmd
9km	9 km
gestoelt	gestoeld
houtgreep	houdgreep
gekuisd	gekuist
Myspell	MySpell
geschaat	geschaad
afgelegt	afgelegd
bedevaartsoort	bedevaartsoord
betanddeel	bestanddeel
12jarige	12-jarige
gehoort	gehoord
voorgestelt	voorgesteld
moskeen	moskeeën
lange-afstandsraketten	langeafstandsraketten
aangeleerdt	aangeleerd
zij-instroom	zijinstroom
geschakelt	geschakeld
0mdat	omdat
GroenLinks-lid	GroenLinkslid
kno artsen	kno-artsen
uitgeleent	uitgeleend
móeten	móéten
ònze	ónze
geïntegreerdt	geïntegreerd
electricien	elektricien
geleit	geleid
warmtekrachtkoppeling	warmte-krachtkoppeling
ebay	eBay
beslisdt	beslist
diskant	discant
o-ring	O-ring
hóeven	hóéven
kongsies	kongsi's
gesmeerdt	gesmeerd
gearresteerdt	gearresteerd
geresulteert	geresulteerd
gereinigdt	gereinigd
gematigt	gematigd
gelogeert	gelogeerd
gefixeert	gefixeerd
toegevrozen	toegevroren
ruimte-tijd	ruimtetijd
crepezolen	crêpezolen
tezetten	te zetten
opgeschut	opgeschud
top-20	top 20
plumeau's	plumeaus
Jezus`	Jezus'
1meter	1 meter
geneigt	geneigd
facebookgroep	Facebookgroep
halloween	Halloween
qwertz-toetsenbordje	qwertztoetsenbordje
London	Londen
gesignaleert	gesignaleerd
familieuitstap	familie-uitstap
gevibreerdt	gevibreerd
haatliefdeverhouding	haat-liefdeverhouding
kitesurfert	kitesurfer
opgezed	opgezet
Cadeau's	Cadeaus
televisiequizen	televisiequizzen
hùn	hún
hercalibratie	herkalibratie
semi-overheid	semioverheid
milieu-effectrapportages	milieueffectrapportages
Informatieuitwisseling	Informatie-uitwisseling
meegetelt	meegeteld
-zal	zal
dinkytoys	dinky toys
nobelprijswinnaars	Nobelprijswinnaars
uitgeroeit	uitgeroeid
gelant	geland
gepolsd	gepolst
doorgereist	doorgereisd
wienerschnitsel	wienerschnitzel
ICT-ers	ICT'ers
geselecteert	geselecteerd
hulpvragend	hulp vragend
hybride-auto's	hybrideauto's
gedoceert	gedoceerd
geoptimaliseert	geoptimaliseerd
gevol	gevolg
schrijfmachien	schrijfmachine
geolieden	geoliede
gewaardeert	gewaardeerd
doorgedraait	doorgedraaid
quite	quitte
afgeleverdt	afgeleverd
geklemt	geklemd
gepresenteerdt	gepresenteerd
cliché's	clichés
gedetailleert	gedetailleerd
-én	én
gemaildt	gemaild
gekrult	gekruld
electriciteitsmeter	elektriciteitsmeter
adjudantchef	adjudant-chef
bassa	Bassa
gevestigt	gevestigd
gooi-en-smijt-films	gooi-en-smijtfilms
scheepverkeer	scheepsverkeer
veeltoegepaste	veel toegepaste
accesoire	accessoire
2miljoen	2 miljoen
gekeurdt	gekeurd
José's	Josés
energieverbuik	energieverbruik
Kastiliaan	Castiliaan
gedoemt	gedoemd
gerespecteert	gerespecteerd
aanbde	aan de
gezoent	gezoend
levencyclus	levenscyclus
gecoòrdineerde	gecoördineerde
m₃	m³
electriciteitsvoorziening	elektriciteitsvoorziening
7cm	7 cm
uitgereikd	uitgereikt
helemal	helemaal
uitgangpunt	uitgangspunt
Gaugin	Gauguin
eenvijfde	een vijfde
geaait	geaaid
daarn	daar
virgo	Virgo
ontmaagt	ontmaagd
veldhuis	Veldhuis
analise	analyse
platgebrandt	platgebrand
germain	Germain
geïnformeerdt	geïnformeerd
-weliswaar	weliswaar
belant	beland
gecorrumpeerdt	gecorrumpeerd
georganiseerdt	georganiseerd
ingeklemt	ingeklemd
gemachtigt	gemachtigd
balladendichter	balladedichter
kandidaatland	kandidaat-land
viskes	visjes
5minuten	5 minuten
has	had
wekflessen	weckflessen
gekookd	gekookt
gefraudeert	gefraudeerd
A4-tje	A4'tje
bon-vivant	bon vivant
milieu-effectbeoordeling	milieueffectbeoordeling
aërobe	aerobe
gecomponeert	gecomponeerd
geteistert	geteisterd
SP-kamerlid	SP-Kamerlid
gefietsd	gefietst
linkercilinder	linker cilinder
logé's	logés
polisie	politie
gepeilt	gepeild
òp	óp
hybride-auto	hybrideauto
1maand	1 maand
gepresteert	gepresteerd
gevergt	gevergd
lokatiekeuze	locatiekeuze
goei	goed
geconcenteerd	geconcentreerd
ruggengraad	ruggengraat
practikanten	praktikanten
gemiddelt	gemiddeld
woordensmederij	Woordensmederij
aaf	Aaf
ginnengappen	ginnegappen
invrijheidsstelling	invrijheidstelling
Lleinpolderplein	Kleinpolderplein
linksrijden	links rijden
woordvoerdster	woordvoerster
geformuleert	geformuleerd
radiouitzendingen	radio-uitzendingen
lokaties	locaties
vroos	vroor
onderzoekwerkzaamheden	onderzoekswerkzaamheden
PvdA-kamerlid	PvdA-Kamerlid
broques	brogues
gelanceert	gelanceerd
ontmoedt	ontmoet
opgepikd	opgepikt
híer	híér
noordpooltocht	Noordpooltocht
para-militair	paramilitair
bonekamp	Bonekamp
bìnnen	bínnen
stedebouwkunde	stedenbouwkunde
80jarige	80-jarige
14jarige	14-jarige
gekarakteriseert	gekarakteriseerd
-zuid	-Zuid
boskes	bosjes
zijpe	Zijpe
stet	stelt
vrouwlijke	vrouwelijke
pseudointellectueel	pseudo-intellectueel
vice-kanselier	vicekanselier
yvonne	Yvonne
gerapporteert	gerapporteerd
idiologie	ideologie
gelult	geluld
gerekendt	gerekend
parijs	Parijs
semi-transparante	semitransparante
Ijzersterke	IJzersterke
gedraaidt	gedraaid
lesie	laesie
informatieuitvraag	informatie-uitvraag
vanalles	van alles
hèm	hém
milieu-onderzoeken	milieuonderzoeken
gesuggereerdt	gesuggereerd
capucijners	kapucijners
Boekenweekessay	boekenweekessay
milieu-activisten	milieuactivisten
lesverstoren	les verstoren
ftp-en	ftp'en
etappe's	etappes
milieu-economisch	milieueconomisch
waand	waant
afgescheurt	afgescheurd
schilpad	schildpad
NEN1006	NEN 1006
ingestemt	ingestemd
milieu-afspraken	milieuafspraken
gehaadt	gehaat
calibratie	kalibratie
gedreigt	gedreigd
Querido`s	Querido's
uitgetelt	uitgeteld
gekroont	gekroond
westerscheldetunnel	Westerscheldetunnel
gegromdt	gegromd
ls	is
indiend	indient
ingekleedt	ingekleed
dinkytoy	dinky toy
buitend	buiten
schen	schenk
katastrofe	catastrofe
oost-west-baan	oost-westbaan
ministerpresident	minister-president
nù	nú
8kg	8 kg
Consultatiebureau's	Consultatiebureaus
politiek-correct	politiek correct
Ijff	IJff
afhadden	af hadden
MixCloud	Mixcloud
geprikkelt	geprikkeld
uitgedijdt	uitgedijd
walkie-talkies	walkietalkies
wildeweg	wilde weg
geconditioneert	geconditioneerd
dié	díé
montessori	Montessori
aangespeelt	aangespeeld
heffingslokaties	heffingslocaties
enqueteformulier	enquêteformulier
uitgebouwt	uitgebouwd
geïoniseerdt	geïoniseerd
Mexico-stad	Mexico-Stad
geoefendt	geoefend
v-hals	V-hals
ingesmeert	ingesmeerd
mien	mijn
politie-organisatie	politieorganisatie
aangerekent	aangerekend
doodgegooit	doodgegooid
kommissies	commissies
patientjes	patiëntjes
glansende	glanzende
gehandelt	gehandeld
weerkanten	weerskanten
kèn	kén
losgebrandt	losgebrand
patiënce	patience
secretaressendag	secretaressedag
jodenkind	Jodenkind
opgezadelt	opgezadeld
ingedeeldt	ingedeeld
avantgardistisch	avant-gardistisch
coulissenlandschapjes	coulisselandschapjes
inburgerings	inburgerings-
linksradicale	links-radicale
gewijdt	gewijd
gezeeft	gezeefd
transactieuitgaven	transactie-uitgaven
bijbelplaatsen	Bijbelplaatsen
mederwerkers	medewerkers
afgebeeldt	afgebeeld
gelijmdt	gelijmd
politiecorpsen	politiekorpsen
milieu-actieplan	milieuactieplan
geadviseerdt	geadviseerd
online-stemhulp	online stemhulp
buske	busje
Lou's	Lous
ingezamelt	ingezameld
super-deluxe	super-de-luxe
cylindrisch	cilindrisch
-één	één
gesproeit	gesproeid
gehoust	gehouset
gevoedt	gevoed
vrozen	vroren
wekflesje	weckflesje
Ov-chipkaart	OV-chipkaart
ontdekdt	ontdekt
gekamt	gekamd
julie	Julie
krobia	krobya
semi-verharde	semiverharde
uitstekkende	uitstekende
SP-ers	SP'ers
aangeduit	aangeduid
klaargestoomt	klaargestoomd
teruggekeert	teruggekeerd
opleidings	opleidings-
gespijkert	gespijkerd
uitgestelt	uitgesteld
gestalt	gestald
voorhout	Voorhout
Scandinavie	Scandinavië
qwertz-toetsenbord	qwertztoetsenbord
geziend	gezien
geassocieert	geassocieerd
bijnadoodervaringen	bijna-doodervaringen
geëxporteert	geëxporteerd
opvanglokaties	opvanglocaties
gereduceert	gereduceerd
gesjeest	gesjeesd
gemaakd	gemaakt
jongentjes	jongetjes
geïdentificeerdt	geïdentificeerd
koninginnedag	Koninginnedag
gereedt	gereed
banus	Banus
handliggende	hand liggende
twee-armig	tweearmig
aërodynamische	aerodynamische
frankenstein	Frankenstein
H2O	H₂O
gescheldt	gescheld
ontmoed	ontmoet
penalty`s	penalty's
prestaiieafspraken	prestatieafspraken
roodlicht	roodlicht-
semi-onafhankelijke	semionafhankelijke
pilske	pilsje
vinex-locaties	Vinex-locaties
gezeurt	gezeurd
Ijzerbedevaart	IJzerbedevaart
aankun	aankan
dislexie	dyslexie
lokatiebeleid	locatiebeleid
coupé's	coupés
toplokatie	toplocatie
naarde	naar de
Scandinavia	Scandinavië
gefilmt	gefilmd
gelogt	gelogd
geweigert	geweigerd
achtienjarigen	achttienjarigen
gevraagdt	gevraagd
4miljard	4 miljard
gewandeldt	gewandeld
vrijeschool	vrije school
salem	Salem
Schaerbeek	Schaarbeek
geschildert	geschilderd
anulair	annulair
geanalyseert	geanalyseerd
gevoetbalt	gevoetbald
gekruisd	gekruist
schrapzetten	schrap zetten
geëindigdt	geëindigd
geïnspireerdt	geïnspireerd
lawinen	lawines
Europarlementariers	Europarlementariërs
gelasd	gelast
gevreest	gevreesd
frequent flier	frequent flyer
A1-lokaties	A1-locaties
gerelateert	gerelateerd
laissez passer	laissez-passer
pilotlokaties	pilotlocaties
geminimaliseert	geminimaliseerd
bijdeze	bij deze
gezorgdt	gezorgd
noordpoolreiziger	Noordpoolreiziger
toeroperator	touroperator
ikheid	ik-heid
deeltijdsfunctie	deeltijdfunctie
gerunt	gerund
komputerprogramma's	computerprogramma's
geweigerdt	geweigerd
ingelogt	ingelogd
diakonessenhuis	diaconessenhuis
gegroeit	gegroeid
5meter	5 meter
ola	cola
vastgesteldt	vastgesteld
nawijn	Nawijn
warmtekrachtinstallatie	warmte-krachtinstallatie
poenale	penale
sportbh	sport-bh
uitgelevert	uitgeleverd
uitgerolt	uitgerold
gebuist	gebuisd
métier	metier
rechtsextremisten	rechts-extremisten
toy boys	toyboys
3minuten	3 minuten
besteet	besteed
gevoerdt	gevoerd
vakantieuitkering	vakantie-uitkering
enquète	enquête
gedroomdt	gedroomd
maneuvre	manoeuvre
afleidingsmanouvre	afleidingsmanoeuvre
geloondt	geloond
pdfje	pdf'je
geheiligt	geheiligd
geciteert	geciteerd
geëvolueerdt	geëvolueerd
gestoffeert	gestoffeerd
geduurdt	geduurd
uitelkaar	uit elkaar
gedachtenstappen	gedachtestappen
geüpdated	geüpdatet
weggegooit	weggegooid
's-hertogenbosch	's-Hertogenbosch
binnengeleidt	binnengeleid
uitgevoert	uitgevoerd
65+er	65+'er
reactie`s	reacties
ontologiën	ontologieën
milieuindicatoren	milieu-indicatoren
bestuursrechterlijk	bestuursrechtelijk
gediagnostiseerd	gediagnosticeerd
sovjetregime	Sovjetregime
lawn	Lawn
sociaalpolitiek	sociaal-politiek
kanaleneiland	Kanaleneiland
tissen	tussen
toegelegt	toegelegd
bevolkd	bevolkt
uitgegooit	uitgegooid
1maal	1 maal
caffeïne-arm	caffeïnearm
prakticanten	praktikanten
milieu-oogpunt	milieuoogpunt
semi-wetenschappelijk	semiwetenschappelijk
aangetekent	aangetekend
toegekendt	toegekend
beleidsniveau's	beleidsniveaus
zorgdraagt	zorg draagt
weggelegt	weggelegd
dealing room	dealingroom
doorgestuurdt	doorgestuurd
gehalveert	gehalveerd
gemund	gemunt
geredt	gered
informatieuitwisselingsverdrag	informatie-uitwisselingsverdrag
-wordt	wordt
skijasje	ski-jasje
afgebrandt	afgebrand
geflikkert	geflikkerd
peuterzoont	peuterzoon
broeikasteffect	broeikaseffect
geleent	geleend
gekantelt	gekanteld
jetskiërt	jetskiër
pseudo-weduwen	pseudoweduwen
uitleglokaties	uitleglocaties
gepaart	gepaard
aangewent	aangewend
geantwoordt	geantwoord
emissie-arm	emissiearm
telastelegging	tenlastelegging
appe`l	appel
koranscholen	Koranscholen
geshowt	geshowd
5mm	5 mm
gecorrigeert	gecorrigeerd
ingescant	ingescand
phytophtora	phytophthora
gedetecteert	gedetecteerd
colokatie	colocatie
geopperdt	geopperd
inkomensniveau's	inkomensniveaus
reisplanner-app	reisplannerapp
koelucht	koellucht
deserts	desserts
5m	5 m
gegront	gegrond
geleveldt	geleveld
gestapelt	gestapeld
fortis	Fortis
èrg	érg
André's	Andrés
brutus	Brutus
àlles	álles
bijgewoont	bijgewoond
top-25	top 25
Relatiecadeau's	Relatiecadeaus
geconcentreert	geconcentreerd
toegestaand	toegestaan
geregent	geregend
starterd	starter
kwaliteitsniveau's	kwaliteitsniveaus
a-politiek	apolitiek
geslaagt	geslaagd
vanacht	vannacht
uitgestaldt	uitgestald
ànder	ánder
tevrede	tevreden
gevarieert	gevarieerd
hesseling	Hesseling
gekoppelt	gekoppeld
opgezegt	opgezegd
afgeschafd	afgeschaft
bijlmerramp	Bijlmerramp
geautomatiseert	geautomatiseerd
hapnotherapeut	haptotherapeut
hippie-achtig	hippieachtig
milieu-ambtenaar	milieuambtenaar
omgebouwdt	omgebouwd
sociaalmedisch	sociaal-medisch
uitgelijndt	uitgelijnd
variantie-analyses	variantieanalyses
geoordeelt	geoordeeld
gemailt	gemaild
10jarige	10-jarige
adjudantchefs	adjudant-chefs
jerimieerde	jeremieerde
-we	we
gesmoort	gesmoord
semi-automatisch	semiautomatisch
béide	béíde
steenwijk	Steenwijk
geneukd	geneukt
gestoort	gestoord
afgevoert	afgevoerd
geopent	geopend
4mm	4 mm
2miljard	2 miljard
vermoort	vermoord
clarence	Clarence
iPhone-bezitters	iPhonebezitters
gekromt	gekromd
afgereist	afgereisd
geblusd	geblust
manouvreert	manoeuvreert
milieu-activiteiten	milieuactiviteiten
zèker	zéker
omfloersd	omfloerst
gerusdt	gerust
top-40	top 40
menskes	mensjes
vastgevrozen	vastgevroren
politie-opleiding	politieopleiding
uitgeholt	uitgehold
manouvre	manoeuvre
Balkenendenorm	balkenendenorm
gelosd	gelost
afschuwlijk	afschuwelijk
gestrandt	gestrand
semi-chronische	semichronische
uitgelegt	uitgelegd
Facebook-profiel	Facebookprofiel
gesmeedt	gesmeed
convooien	konvooien
6miljoen	6 miljoen
kamerlidmaatschap	Kamerlidmaatschap
gebouwden	gebouwde
gooi-en-smijt-werk	gooi-en-smijtwerk
gebrachd	gebracht
milieuinnovatie	milieu-innovatie
getooit	getooid
des konings	des Konings
zakdoekje-leggen	zakdoekjeleggen
genoteerdt	genoteerd
blindde	blinde
geaccordeert	geaccordeerd
opgehaalt	opgehaald
geclaimt	geclaimd
qwertz-klavieren	qwertzklavieren
teruggestord	teruggestort
gedachtengang	gedachtegang
geniedt	geniet
gefractioneerdt	gefractioneerd
noordzuidverbinding	noord-zuidverbinding
geordonneerdt	geordonneerd
oma`s	oma's
desert	dessert
40+ers	40+'ers
75km	75 km
95km	95 km
dédain	dedain
huib	Huib
geavanceert	geavanceerd
politiecordon	politiekordon
gepleegt	gepleegd
toplokaties	toplocaties
Ijslandse	IJslandse
ànders	ánders
aangeduidt	aangeduid
afgekeurdt	afgekeurd
geraced	geracet
electriciteitsverbruik	elektriciteitsverbruik
biblebelt	Biblebelt
opgeleit	opgeleid
A5je	A5'je
loofhuttenfeest	Loofhuttenfeest
gezorgt	gezorgd
New-Yorkse	New Yorkse
kleinsaf	kleins af
3weken	3 weken
Nòg	Nóg
geserveert	geserveerd
voormij	voor mij
para-medische	paramedische
65+-ers	65+'ers
cliché-beeld	clichébeeld
de-radicalisering	deradicalisering
hoogrendement	hoog rendement
getrapd	getrapt
opgehaaldt	opgehaald
yakmest	jakmest
nie	niet
bezinestations	benzinestations
gekoppeldt	gekoppeld
Doom3	Doom 3
kènt	ként
vice-voorzitterschap	vicevoorzitterschap
geëxamineerdt	geëxamineerd
nederlandstalige	Nederlandstalige
nagestreeft	nagestreefd
blootgelegt	blootgelegd
milieu-economische	milieueconomische
reclameuitingen	reclame-uitingen
ontschot	ontschoot
gerommelt	gerommeld
geluistert	geluisterd
geplaatsd	geplaatst
geconfronteert	geconfronteerd
informatie-architectuur	informatiearchitectuur
gerepareert	gerepareerd
geleegt	geleegd
ontrokken	onttrokken
lichtgewichte	lichtgewicht
opgebouwdt	opgebouwd
gerecruteerd	gerekruteerd
caissieres	caissières
halucinerend	hallucinerend
voork	voor
discjockey	diskjockey
2km	2 km
Lokaties	Locaties
efteling	Efteling
aangeleert	aangeleerd
toegekent	toegekend
fietskes	fietsjes
afgelopend	afgelopen
wedstijd	wedstrijd
gecruist	gecruiset
afgeremt	afgeremd
A4-tjes	A4'tjes
Hoogvlakte van Nieuw-Kastilië	Hoogvlakte van Nieuw-Castilië
vice-presidentskandidaat	vicepresidentskandidaat
geknuffelt	geknuffeld
gespecificeert	gespecificeerd
geformuleerdt	geformuleerd
geïntroduceert	geïntroduceerd
geroert	geroerd
pseudo-wetenschapper	pseudowetenschapper
aërosol	aerosol
college's	colleges
besturingsysteem	besturingssysteem
verkleet	verkleed
woonlokatie	woonlocatie
dorpstraat	Dorpstraat
hapnotherapeuten	haptotherapeuten
geveldt	geveld
beschudt	beschut
inbrekert	inbreker
lievende	levende
overheidssubsidiering	overheidssubsidiëring
gekeurt	gekeurd
Facebook-gebruikers	Facebookgebruikers
júist	júíst
Riccò	Ricco
5jarigen	5-jarigen
vice-gouverneur	vicegouverneur
gekolft	gekolfd
practische	praktische
Pvda'er	PvdA'er
bijna-dood-ervaring	bijna-doodervaring
geregeert	geregeerd
gegijzelt	gegijzeld
labellen	labelen
meegespeelt	meegespeeld
friese	Friese
premieuitgaven	premie-uitgaven
siene	sirene
wandspanner	wantspanner
aangeklaagt	aangeklaagd
bouter	bouder
getitelt	getiteld
West-Zeeuws-Vlaanderen	West Zeeuws-Vlaanderen
afgekondigt	afgekondigd
samenwerkingverband	samenwerkingsverband
studentenkorps	studentencorps
Scandinaviers	Scandinaviërs
convooi	konvooi
gehult	gehuld
gekiepert	gekieperd
gewoedt	gewoed
50+er	50+'er
gemakt	gemaakt
milieu-activist	milieuactivist
Tunesie	Tunesië
zee-armen	zeearmen
diagnostiseren	diagnosticeren
toevalig	toevallig
doorgemeldt	doorgemeld
uitgevaardigt	uitgevaardigd
konijnenburg	Konijnenburg
coulissenlandschappen	coulisselandschappen
overgeschakelt	overgeschakeld
wandspanners	wantspanners
broque	brogue
ontbloodt	ontbloot
gevoert	gevoerd
opgelosdt	opgelost
persentage	percentage
tracé's	tracés
hobby`s	hobby's
olieindustrie	olie-industrie
verschuren	verscheuren
reclame's	reclames
geraamt	geraamd
móest	móést
gedeblokkeert	gedeblokkeerd
geprobeert	geprobeerd
homohuwlijk	homohuwelijk
Ijsbrand	IJsbrand
onderwij	onderwijs
ècht	écht
bolland	Bolland
ja-knikker	jaknikker
gepersd	geperst
politie-adviseurs	politieadviseurs
uitgeoefent	uitgeoefend
vooreen	voor een
Ijskoude	IJskoude
idols	Idols
gereguleert	gereguleerd
opgedeeldt	opgedeeld
sponsert	sponsort
top-16	top 16
dienstplichtingen	dienstplichtigen
moskeeen	moskeeën
maneuvreren	manoeuvreren
bubs	bups
gesteldt	gesteld
afgevrozen	afgevroren
gezegt	gezegd
uitgezondert	uitgezonderd
zieleroerselen	zielenroerselen
grondstewardes	grondstewardess
stage-achtige	stageachtige
oostbloklanden	Oostbloklanden
zzp-ers	zzp'ers
gedumpd	gedumpt
aangehaalt	aangehaald
oudergewoonte	ouder gewoonte
rechtercommissaris	rechter-commissaris
Ijben	IJben
gedompelt	gedompeld
breden	brede
sin	in
bij-effecten	bijeffecten
's-Gravenmoer	's Gravenmoer
milieu-opzicht	milieuopzicht
3km	3 km
babyzitters	babysitters
gesteunt	gesteund
b-kantjes	B-kantjes
gefreest	gefreesd
gehercalibreerde	geherkalibreerde
gebouwt	gebouwd
reincarnaties	reïncarnaties
accupuncturisten	acupuncturisten
4cm	4 cm
2maanden	2 maanden
geconfronteerdt	geconfronteerd
madonnabeelden	Madonnabeelden
uitgenodigt	uitgenodigd
vice-presidentskandidaten	vicepresidentskandidaten
getuigeverklaringen	getuigenverklaringen
geaardt	geaard
opgevraagt	opgevraagd
gedupeert	gedupeerd
75+ers	75+'ers
klassejustitie	klassenjustitie
afgeplatten	afgeplatte
kontent	content
rondgebreidt	rondgebreid
afgekoppelt	afgekoppeld
meermaal	meermaals
Ijsbaan	IJsbaan
leiddraad	leidraad
zowieso	sowieso
freestylert	freestyler
teneergeslagen	terneergeslagen
feestlokatie	feestlocatie
gesmokkelt	gesmokkeld
SP-Fractie	SP-fractie
klasses	klassen
bouillabaise	bouillabaisse
bleutooth	bluetooth
toy boy	toyboy
weggeëbt	weggeëbd
NEN1010	NEN 1010
milieu-organisaties	milieuorganisaties
achtiende	achttiende
uitgepland	uitgeplant
wij-zijgevoel	wij-zij-gevoel
gezindt	gezind
wijdsheid	wijsheid
opgeheldert	opgehelderd
proffessioneel	professioneel
politie-actie	politieactie
uitgerede	uitgereden
gebauwde	gebouwde
2mei	2 mei
gesynchroniseert	gesynchroniseerd
metro-achtige	metroachtige
teneer	terneer
àls	áls
einderonde	eindronde
aberant	aberrant
gejaagdt	gejaagd
geprotesteert	geprotesteerd
gecommiteerd	gecommitteerd
Lokatie	Locatie
plateau's	plateaus
software-ontwikkelaar	softwareontwikkelaar
co-commentator	cocommentator
intercalibratie	interkalibratie
opgeschoont	opgeschoond
naarboven	naar boven
vereisd	vereist
gecontinueert	gecontinueerd
gloei-ovens	gloeiovens
Hawai	Hawaï
gemartelt	gemarteld
EEG-Richtlijn	EEG-richtlijn
aangedraait	aangedraaid
a.d.h.v	a.d.h.v.
stilgelegt	stilgelegd
toyota	Toyota
vriende	vrienden
geloost	geloosd
Barger-Compascuüm	Barger-Compascuum
Zò	Zó
gepasseerdt	gepasseerd
praten als brugman	praten als Brugman
semi-feodale	semifeodale
mafia-achtige	maffia-achtige
gedeclareert	gedeclareerd
geheidt	geheid
aangelijnt	aangelijnd
reisbureau's	reisbureaus
s-bocht	S-bocht
opgeleidt	opgeleid
quasi-diepzinnige	quasidiepzinnige
onderde	onder de
semi-autonoom	semiautonoom
des gevallend	desgevallend
2minuten	2 minuten
milieu-aspecten	milieuaspecten
sint-bernardhondjes	sint-bernardshondjes
ongever	ongeveer
vrijetijd	vrije tijd
gepraktizeerd	gepraktiseerd
glooingen	glooiingen
klassediagram	klassendiagram
qwertz-klaviertjes	qwertzklaviertjes
2weken	2 weken
gelegerdt	gelegerd
uitgevoerdt	uitgevoerd
gesukkelt	gesukkeld
voostel	voorstel
helloweenfeest	halloweenfeest
noord-zuid-richting	noord-zuidrichting
onmiddelijk	onmiddellijk
gekwalificeert	gekwalificeerd
opgegroeit	opgegroeid
half twaalf	halftwaalf
anti-rooklobby	antirooklobby
gecensureert	gecensureerd
volkstam	volksstam
geerfd	geërfd
masqué's	masqués
onbesuiste	onbesuisde
49km	49 km
halucineren	hallucineren
hiér	híér
manoevreren	manoeuvreren
cylinderinhoud	cilinderinhoud
aanbik	aanblik
Oost/Watergraafsmeer	Oost-Watergraafsmeer
gesodemieterdt	gesodemieterd
9cm	9 cm
begrom	gegrom
kayaktocht	kajaktocht
geretourneerdt	geretourneerd
kalfzwezerik	kalfszwezerik
ìn	ín
terwiji	terwijl
teweten	te weten
heengetild	heen getild
spercieboon	sperzieboon
cylinder	cilinder
geschoeidt	geschoeid
gedachtenstrepen	gedachtestrepen
ondergedompelt	ondergedompeld
geschaart	geschaard
tractaat	traktaat
exports	export
gecheckd	gecheckt
Koningrijk	Koninkrijk
annemiek	Annemiek
aïda	Aïda
Ijdel	IJdel
goedgekeurdt	goedgekeurd
reincarnatie	reïncarnatie
heiligheit	heiligheid
GroenLinks-leden	GroenLinksleden
8miljoen	8 miljoen
gezwaait	gezwaaid
woudbloem	Woudbloem
beheersd	beheerst
gepledt	geplet
teruggemeldt	teruggemeld
auto`s	auto's
milieuimpact	milieu-impact
teniet gedaan	tenietgedaan
wijndrinken	wijn drinken
genegeert	genegeerd
salaam aleikum	salam aleikum
kerkstraat	Kerkstraat
maïslabyrinth	maïslabyrint
geïnteresseert	geïnteresseerd
accomodaties	accommodaties
vertouwen	vertrouwen
geknaldt	geknald
kostenloos	kosteloos
vervalsd	vervalst
para-medisch	paramedisch
tengevolge	ten gevolge
waarschijlijk	waarschijnlijk
huwlijken	huwelijken
practischer	praktischer
gewroedt	gewroet
gedouchd	gedoucht
uitbreidingslokaties	uitbreidingslocaties
uitgeplunderdt	uitgeplunderd
lk	ik
geprogrammeert	geprogrammeerd
ingetekent	ingetekend
superde-luxe	super-de-luxe
òfwel	ófwel
uitgegroeidt	uitgegroeid
opgetrommelt	opgetrommeld
meegelevert	meegeleverd
electriciteitsbedrijf	elektriciteitsbedrijf
lokatiespecifieke	locatiespecifieke
deeltijdsbaan	deeltijdbaan
Denny`s	Denny's
gevingert	gevingerd
dubbel-cdeditie	dubbel-cd-editie
laisser aller	laisser-aller
uitgeweidt	uitgeweid
geweert	geweerd
magazine-achtige	magazineachtige
opgeruimt	opgeruimd
minder-validen	mindervaliden
ingeluidt	ingeluid
booi	boot
calligrafie	kalligrafie
rij-instructeurs	rijinstructeurs
roodwitte	rood-witte
top-50	top 50
geboeidt	geboeid
Nederlands Antilliaans	Nederlands-Antilliaans
lageronderwijs	lager onderwijs
rekreatie	recreatie
vastgeklemt	vastgeklemd
geklaart	geklaard
semi-dwingend	semidwingend
gewaat	gewaad
uitgewoedt	uitgewoed
momt	komt
17jarige	17-jarige
gecontroleerdt	gecontroleerd
gepresenteert	gepresenteerd
bevrozen	bevroren
gepint	gepind
maseurtje	masseurtje
gekopieerdt	gekopieerd
1m²	1 m²
Ijtsma	IJtsma
milieu-adviesbureau	milieuadviesbureau
prijsniveau's	prijsniveaus
genant	gênant
PVDAer	PVDA'er
Lazio`s	Lazio's
1cm	1 cm
speci	specie
milieu-aspect	milieuaspect
wetenscha	wetenschap
9mei	9 mei
lounge-achtige	loungeachtige
qwerty-toetsenbord	qwertytoetsenbord
behoet	behoed
Montessorri	Montessori
geadt	geat
gemodificeert	gemodificeerd
3m	3 m
vervuren	Vervuren
gevolgdt	gevolgd
bijgeschaaft	bijgeschaafd
moskeet	moskee
Vinexlocatie	Vinex-locatie
kokus	kokos
bijgelegt	bijgelegd
drap	drab
gemanoevreerd	gemanoeuvreerd
ontplooiien	ontplooien
manouvreerruimte	manoeuvreerruimte
politie-auto	politieauto
n.v.d.r	n.v.d.r.
Ijmuiden	IJmuiden
geupgraded	geüpgraded
informatie-avonden	informatieavonden
geforceert	geforceerd
electrische	elektrische
bordspellen	bordspelen
Nobelprijs-winnaars	Nobelprijswinnaars
kamerlid	Kamerlid
gehuisvesd	gehuisvest
gedemonteert	gedemonteerd
4GB	4 GB
interveniëerde	intervenieerde
geringt	geringd
verkiezings	verkiezing
parauniversitaire	para-universitaire
bondsdagverkiezingen	Bondsdagverkiezingen
gehaalt	gehaald
ruiterskorps	ruiterkorps
aangespoelt	aangespoeld
zééér	zéér
attache	attaché
informatieuitwisselingen	informatie-uitwisselingen
geadopteert	geadopteerd
massauitsterving	massa-uitsterving
café's	cafés
gedachtengangen	gedachtegangen
adrem	ad rem
opgeoffert	opgeofferd
top-12	top 12
opgewarmt	opgewarmd
afgezegt	afgezegd
geretourneert	geretourneerd
ingebouwt	ingebouwd
taand	taant
strofenvorm	strofevorm
cruiseschip-spotter	cruiseschipspotter
zeergeëerd	zeer geëerd
òm	óm
gemundt	gemunt
Vinex-lokatie	Vinex-locatie
verblijfsaccomodatie	verblijfsaccommodatie
gastouderbureau's	gastouderbureaus
glazend	glanzend
ezelsproces	Ezelsproces
Vinexwijk	Vinex-wijk
top-24	top 24
9mm	9 mm
gebelt	gebeld
verlosd	verlost
geërft	geërfd
geanimeerdt	geanimeerd
qwerty-klaviertje	qwertyklaviertje
sempel	stempel
status-quo	status quo
top-4	top 4
maria	Maria
septer	scepter
vos-cursussen	voscursussen
presidentsschap	presidentschap
verzende	verzenden
telefoonsgegevens	telefoongegevens
Helloween	Halloween
crepezool	crêpezool
oudeman	oude man
spercieboontjes	sperzieboontjes
uitgavepatroon	uitgavenpatroon
Bijiagen	Bijlagen
deeltijdsbanen	deeltijdbanen
identifceren	identificeren
getrakteert	getrakteerd
geabsorbeert	geabsorbeerd
bolsjevistische	bolsjewistische
geamuseerdt	geamuseerd
gehandhaaft	gehandhaafd
etage's	etages
gesneeuwt	gesneeuwd
roodbol	Roodbol
doodgebloedt	doodgebloed
aangeschafd	aangeschaft
normaalgesproken	normaal gesproken
ingediendt	ingediend
aangerandt	aangerand
bijde	bij de
geamuseert	geamuseerd
gelocaliseerd	gelokaliseerd
Nusta	Ñusta
televisie-programma	televisieprogramma
azerty-klavieren	azertyklavieren
gecoördineerdt	gecoördineerd
geloodsd	geloodst
gevolgt	gevolgd
Europarlementarier	Europarlementariër
transscriptiefactor	transcriptiefactor
gecoachd	gecoacht
qwerty-toetsenborden	qwertytoetsenborden
uitgerekent	uitgerekend
geflikkerdt	geflikkerd
gerodeerdt	gerodeerd
tègen	tégen
gehalveerdt	gehalveerd
torend	torent
uitgedraait	uitgedraaid
afgebakent	afgebakend
stage-adres	stageadres
losgekoppelt	losgekoppeld
politie-agente	politieagente
rechtzitting	rechtszitting
death metal	deathmetal
verwachd	verwacht
vitamine c	vitamine C
cylinders	cilinders
afgedroogt	afgedroogd
gebaldt	gebald
achtergezet	achter gezet
baby`s	baby's
dil	dit
aanrijdtijden	aanrijdtijden
XTC-achtige	XTC-achtige
